string[s]	string
"Hello World!"	"e lHloWrdlo!"
"fgdgoaxmkpzgidgtckaiggzlpupd"	"gapdkgufdoxkzigcagzppgmgtild"
"opucjkynnipxaxrtrizqghrpstnejzmopiispm"	"pkixihtzimoujynparrzgrsnjmpipcnxtqpeos"
"hgceppzu"	"gphcpzeu"
"konkwljeyuh"	"oluknwjyhke"
"wxoscndwfgykkuq"	"xnguwocdfykqswk"
"bvxdhmrkltulkczugwfvyegxevvbjxydykovtqimtimucwzovwlbrekpuvt"	"vmtcwevxkqiwwevbxhrlukzgfygevjyyotitmczvlrkutdkluvxbdvmuobp"
"wxu"	"xwu"
"nrszps"	"rsnspz"
"xphmjorovvgrvpjotphbrygwgwvshx"	"povppywxxhjrvgvjthrggvhmorobws"
"bjgskylepzgpwaryg"	"jyzabgklpgwrgsepy"
"ytjexvlidrodohqmygaevwlywadngfinpobitzwwsjppervgfbimaefmdwwgqhbnbloiggebflwiddxkvnelsgbkrqkzgmhxdzvckshewudpqgupfdbldwxfsf"	"tvrhgwafozjrbewhlgldngqmzsugdwfyjxldooqyavlwdgipbtwspevfiafdwqbbogefwdxvesbrkghdvkhwdqufbdxseidmeynniwpgmmgnibiklkzxcepplf"
"swpbwgxworrvckwdffcrdqsvpmmgjrqpyxzoecxspsltezzjozgoypkecthveofckspouswnjxupporrchgpgdivndleopbyjrbcejilovwvsmu"	"wgrkfqmrxcszzptossxohddprjvmspwxorcwfcdspmjqyzexplezogykchefkpuwjuprcgginlobjbeiowsubwvdrvgpostjoevconprpveyclv"
"fnsegqknfqcufkmatuyszrchxsxpmsscpadixiehxanosperzjyibvufg"	"nqqkurssaiapjvfsgkfcfmtyzcxxmspdxexnsezybugenuashpcihorif"
"vsxfmornzkgvohocfohkgqxbkuxexlilpxqbtduxgkqoyuudsxgthtkdyhezoughwfqluggsnnznvhctxufxeoaoyqkydaerdjgjvggkhdpbxojnhmkzvyse"	"sokhoqulxdkuxthufgnhuoqajgdomyvxmrzgoofhgxkxxipqtugqyusghkyeogwqugnzvcxfeaykdedgvghpxjhkvsfnvckbelbxodtdzhlsntxoyrjkbnze"
"yfskonlgcnwbrmvcdgohbububxqbduxmouwwnhrjnydrxlkai"	"fnnmguxuuhylysolcwrvdobbbqdxownrndxkikgbchubmwjra"
"eustqdgtau"	"uduesqgatt"
"jlkapkadhtrhwwszgkmtsvyeoljq"	"lktwkvljkpahrwsgmsyojadhzteq"
"hjoltipaelrlx"	"jilhotperxlal"
"hpzkpzkapydykliysimlhovebghnsbljirbzvzioacjzp"	"pzyliogbrzchzpkpdkismhvbhslibviajpkayylenjzoz"
"yexarpzpjbdhztvxseavx"	"epbteyxrzjdzvsaxaphxv"
"ylnkoorsnekhvbrwfr"	"loebrynornkvrfkshw"
"fyjamhampacjrjmnhhc"	"yhajhfjmapcrmhcamjn"
"dqgosrawmqfdf"	"qrqdgsamffowd"
"rinkgwhuunkrbqhrtbjvetvyavwxk"	"iwnqbtvrnghukbhtjevawkkurrvyx"
"zcpyjrlmvswkotb"	"crstzpjlvwobymk"
"epuoswgjjcubzn"	"pwcneusgjuzojb"
"itbllqxzixlofvfbbostbacdolsseusgbmsrqpzdqdaen"	"tqxvoalumpdiblxilffbsbcosesbsqzqanlzobtdsgrde"
"purlneqaggdngbkqnibicmkledriboklingjcbuiknrxczoznyzmtgovay"	"uegbimdonbnzygyprnqgdgknbckerbkigcukrconztoalanqililjixzmv"
"fubpqfl"	"uffbqlp"
"xejxyqvzjoggiwh"	"eqowxjyvjgihxzg"
"snfohsprcsjfecgzdcnalpunkvflztn"	"nssccpvtsfhpcjegdnlukfznorfzanl"
"dfow"	"fdow"
"wnewxathbufqobtyixqfdqvlddmyxqtdijhlqxnhtjqkmlxyiqjheoyeymsxintrktfwyqiosrlrnfcxrmlirz"	"naubxqdqjxjlqomntqrfmzwextbfotiqdvdmxtihqntqmxijeyysitkfyislncrlrwhqyflydlhkyhexrworxi"
"sfoqilbvcdchanmjkahvzfhy"	"fldnafsoibccamkhzhqvhjvy"
"olofvuveqddwuoxgyfcgcgyytupwkpthsddcndwtjyaekufnkvdlbjonqehrzyepeuokwmpyzbeirtvjfjimgduupnilltwukgoaorwmpkuprjakbxnuonolitroo"	"ludofgupddyuvjeyumbtjdntgrkjxntoovvqduxyccytpktsdnwjakfkdboqhzeeowpzervfigupilwkoowpurabnooirofewggywhctenlnrpkyijmuluampkulo"
"uqesqfbeajndpujzaulranmbbnoljknkbhc"	"qfjuunnkhueqbanpjalambojnbcsedzrblk"
"ofvtj"	"fovjt"
"jtseanneeczwgve"	"tncvjsanezgeeew"
"alfpfubsmvyukxjcfarzwgebp"	"luvxagaffbmykjfrweppsuczb"
"cag"	"acg"
"xsysioaouzemy"	"sozxyiaueysom"
"rgofgvnjzpsycwkiydjjdsjdmxpie"	"gvpwdsxrognzsckyjdjmpefjyijdi"
"jttdiejwksdxelyolldraqowjhhbioitnvfeldgcymmsrtgypwtfuwelif"	"tesllqhovdmtwwfjtijkdeyldaojhiinflgymrgptueidwxorwbtecsyfl"
"lvzgjtjrd"	"vtlzjjdgr"
"nwbafnytpqa"	"wnqnbfypaat"
"mhs"	"hms"
"cmswu"	"mcsuw"
"ojfbgxsibhaykxbbydy"	"jxhxdofgsbakbyybiyb"
"call"	"acll"
"socieusiecpzcbjcgnnsijcaucvlltqwofpyfohhqdhfbamkffheyunoasdrpbgdomyrudrwdtwmvobunvzdbz"	"oucbnjctfodafusbmdtovzscesepcjgnicuvlqopfhqhbmfhynadpgoyurdwvbnzbiizcsalwyhfkeordrwmud"
"gji"	"jgi"
"cdlgdag"	"dacldgg"
"quajrblup"	"ubqarlpju"
"fjhfmatjd"	"jafhmtdfj"
"ibcxt"	"bictx"
"ehaxovdrysixnfhhncaryijhzzpemianpzavurauqlwayguxlypjyocbgkwtohtziymbdxbxmseikwitzrwnjscaxjrueqd"	"hvsfcizizrlgyokhyxswrsjqeaodyinhnayjzpmapauaqwyulpycgwotimdbmekizwjcxredxrxhrhenvuaxjbtzbxitnau"
"yttkbsnxelfivllenwpyueqvbkvjsgyecdecpwxjqqvvxddmojlxtodeimkbjymrugmtetoazxoqm"	"tsllwekgdwqdjomygtxytbnefvlnpuqbvsycepxqvxdoltdikjmumeozomkxieyvjecjvmxebrtaq"
"cljjubdncqibloqirprwaneryzoeapf"	"lbqopnzpcjudcilqrraeyoafjnbiwre"
"exnogcjqjlhllumavvufezx"	"xcluvzengjjhlmvuexoqlaf"
"ojcskysypritbjmcmqakcsypovrontyr"	"jyrjqsvtockspibmmacyornysytckpor"
"sdffu"	"dsfuf"
"qljiqnmdkclaynbhbrtqurzggcfkekphve"	"lncnrrckeqjqmklybbtuzgfepvidahqgkh"
"emoedpahufpmmuprdlpnnsdkqivadwwjsubnfqrbidsjieischhlaeuvdbqilawpgskqyu"	"mpfulsiwuqdehebasueodaupmpdpndqvdwsbfrisiichaudqlwgkyehmrnkajnbjslvipq"
"pmhsaqayeurihgplpcziklrlqzqavfirnajbfmquudzwva"	"mqugclzfamdaphaaerhppzkrqqvinjfquzvsyililarbuw"
"bnlwikbspbrbft"	"nkbtblibprfwsb"
"sqqhwoxjbysywunpbogwytiwj"	"qoyuotsqwxbswnbgyijhjypww"
"zzwhghqxpwhh"	"zhwzwgqphhxh"
"yvw"	"vyw"
"sxidektkoxcitrsdzmirnomzmdebeyvtljfybcnbfmuporvbmwdbjdndauinnlvrfonaggyoo"	"xkxrmodyjcmrwdulogsietoctszinmmeevlfbnfuovmdjnainvfngyodkidrzbtybpbbdnrao"
"oppneat"	"paopetn"
"yhwrvc"	"hcywvr"
"phduremmfzvxpm"	"hezmpdrmfvpumx"
"jwabxtxzujtuzwenfnfysohvmgjkyutfhurposmaoexbgcecxlnjfhtrimcivsctjyomnumvuitut"	"wtjwnoguuseclhmsyuijaxxutzeffshmjythromoxgexnfticvcjonmuttbzunyvkfpabcjritmvu"
"lhrfmngdcum"	"hnulrmgcmfd"
"bnnvve"	"nebnvv"
"lyhgernzvxzztomuuvuunzpaepe"	"yrxovzplhenvztmuunpeegzzuua"
"cmbdoyafbcozmsibwlijkzeoxvej"	"mycslzvcboabomiwikexedfzbjoj"
"ofktxqsbjwzchqsqrvoqmnytzcgadnvpsnjqagmqjesuuuryqrchdwazbyojhkvguklmibogrmhpgjhqwjerdviunvthtkfoyp"	"fqwqvncnngeurwykkbmjjvvkpokxsjzhsromyzgdvsjamjsurqcdabohvuliorhghwedinttfytbcqqtapqquyhzjgmgpqruho"
"gikexhvdlggqqetpckypjdopiyeyrdsecuopvgyleyuik"	"ihgekdydugygkxvlgqtcyjoierscovyeukedqpppyepli"
"ruttkmxesoe"	"umortkxsete"
"vthddifyhkfhdzwtui"	"tikzivhdfhfdwudyht"
"wftwmd"	"fdwtmw"
"zepvki"	"eizpkv"
"mvupjkalnltvrd"	"vkldmujantrplv"
"wddo"	"dwdo"
"kjkvewasyarbdeegtypbe"	"jwaeykkeayrdetpevsbgb"
"wjpukgxclbdchjctmdfrjlpst"	"jgbjdlwpkxldhcmfjptucctrs"
"xby"	"bxy"
"moftgiaxofjwwswjyqfocdfdepjeezzhqczqsxmkggkfmsfnjnmpovxtjxjsynuweukjxhqvpfrfpbfwvzsdqszfciidnazsske"	"oifsqdpzcxgsnvxnuhfbzsiakmfgaojwwyfcfejezqzsmgkmfjmoxjjyuekxqprpfvsqzcinzsetxwjodehqkfnptswjvfwdfds"
"ltpwlasxklfrclgzekoztyienevglzdhqqwdh"	"tallkyezqlplskfcgeotinvldqwhwxrzzeghd"
"mrkxirzttilpsupsgmmeaauhqhmimjwzvfxbewmydywyuagynnyihf"	"rriumahjfwyanfmkiztlspgmauqmmwvxemdwugnyhxtpsehizbyyyi"
"mft"	"fmt"
"vvcbeaoba"	"vavceoabb"
"waqy"	"awqy"
"qlbgfgfslqkhzpegyabhwempwwgwaingioskziekjnyrtnqglddxqzbkb"	"lgqpaewioinndzqbfflkzeybwmwganiszejytqldqbbgshghpwgkkrgxk"
"jmjyahbvneiqpeutfob"	"mheeojjabnipufbyvqt"
"pfktps"	"fspkpt"
"pab"	"apb"
"wyeslmhracpidmsxdfennuyizufritcntivkmifuiedlfjdncfxgkfrnryglwocyaenvwcwwtnezboatenbakllnibghieixhvgnbblmrewrmngf"	"ymcmfuutiiejffyoecnonlbevbenwelhapdsdenyzfictvmfidfdcxkrrgwcanwwtebaebkligiihgblrwmgsrixnirnkulngnlyvwztanhxnmrf"
"xkqzdqcjnfwruvlyyjxsyvh"	"kqfvjvxqdcnwulyxyhzjrys"
"vtn"	"tvn"
"xwxqsbxjusikzxbjnfwoqpvdpjcjdjxuhdyylexjh"	"wbsxfpjjdexxsxuizbnwqvpcdxhylxhqjkjodjuyj"
"brofqaxxbcbmflxrtpxnpkrqomkzuplcbmjdnun"	"raclpkmpmuboqxbbfxtxprokulbjnnfxmrnqzcd"
"uqp"	"qup"
"ivswyedmltuxyrnxnfquokdctvxmuffcukbzpnvvbvgzurwhmtwchryyxt"	"vetrfkvfknvrtrtisydluynnqodtxufubpvbguwmwhyxwmxxucmczvzhcy"
"uuqpddbwdsizvtwphejuhmkyvfcrhfuegnbcesaqxrrdmylrjbcqfxgqmueamcvxquyqbcvj"	"udstemffnsrybxucucuqdbdivwhjhkvchugbeaxrmljcfgmemvqybvpwzpuyrecqdrqqaxqj"
"xcb"	"cxb"
"emiucwkcofvzqduvwkmatlijhqwvudmqtlgdwjgzvwgghneodtfzswpznzkdofnoubldxdcdq"	"mwfdklqdljwntwzfbdeickovquwmtihwumtgwgvghedfspnkonulxcquczvajvqdzgozzdodd"
"mptnwexjysdktytgkdhowkhkohilbw"	"pesydkhwmtwxydttkhwhoibnjkgokl"
"mzo"	"zmo"
"dbww"	"bdww"
"dewhzeiodrvdbhpjkbibaoioul"	"eerhboldwzidvbpkiaiuhodjbo"
"spkvmgdkkpqzh"	"pgpskmdkqhvkz"
"atylbb"	"tbaybl"
"jhdoi"	"hjdio"
"thl"	"htl"
"uzretk"	"zkurte"
"nefazypiu"	"eynfzpuai"
"ppnrrmelkc"	"pmcpnrekrl"
"kycqjwiftqnkb"	"ywqkcjitnbqfk"
"bbuegymp"	"bybugmep"
"jvktwzkxhoij"	"vzojkwkhitxj"
"ohxjscnpxzvfnlobxyrzdwqwkdbigro"	"hczlywdroxsnxvnoxrdqkbgojpfbzwi"
"srzcisialygqzoggvbojroavuvz"	"rsyobovsziilgzgvorauzcaqgjv"
"dxiqooe"	"xodioeq"
"jqgv"	"qjgv"
"ttt"	"ttt"
"cmaqzhlvmsdpmvmkgksqfgylalbednvkngllpdhqxmtelhhzfezunwlolgbciwyfehyivjnxjqujdccwvvzollmiqj"	"mhsvkglngdmhewgwhjqcvljcazlmdmmgsfyabdvnlphxtlhfznllbiyeyvnjudcvzlmqqvpkqleklqezuocfixjwoi"
"socmr"	"oscrm"
"nmqyddjbxflbrvxjwwpnlwadmngjsbcxdgyqchcuogkhrkrgzccpzhqzuuqbmuouerrlcsloqjndbentvdhnisiuoyyipsjejuuivqnvmrtpkwhilzxmgn"	"mdfvwwnbghgkchuursjedsysuqrwznnqdjxlrxwplamgscdyccokrrzczquqmoerclqnbnvhiioypjjuvnmtkhlxgybbjndjxquhgpzbulodtnuieivpim"
"ooselc"	"ocosle"
"neiugmsfltysxo"	"emtonigslyxufs"
"iqjcblht"	"qlijbhct"
"pheu"	"hpeu"
"trgnajacrnkwofzpocctlonj"	"rjnfcotgaarkozoclnncwptj"
"ieqqkcgyyr"	"ecriqkgyqy"
"ubzjkbuifsndmbqycbadkjxfwpzvibyugemsbbbxgkpopcozhaiiziaj"	"bbsbbjpbebkcaiuzkufnmqcakxwziygmbbgppohizajidydfvusxozij"
"ptyzfaa"	"tapyfaz"
"ywyqxxxookhlpccamsvymzrvtmphfveakeclsmsznfriaulzpxritwvlbxrwngeagfxhgmgccbfhekacinwlrdasj"	"wxkcszmvemfuxwxgfmbkndyyxxohpcmvmrtpfekcssnralprtvbrnegxggcfeaiwrajqolayvhalzizilwahchcls"
"mdqputnnqyozf"	"dtymqunqofpnz"
"rkr"	"krr"
"oxmkyrxvcycyixnklytrdlrrcvemsqazanwdttzexmazhxvjlmugodtnmkepkjqnzwqlfzrnsfoikntlvjwfeacreunahdumfykixerhkpwtxtooitkbu"	"xryxylvqntmxmdkjwzfnjaudyepttomyxccinltdrcesaawtzxahvluotmekqzqfrsoktvwecenhufkxrkwxoikukvykrrmzdezjgnpnlnilframihtob"
"bkbpsmqtpelg"	"kmebbsqplptg"
"kspwxpbjvqerecbuzmvzo"	"spqcmkpxbveebzvowjruz"
"dznuhwjfqzo"	"zwzdnhjqouf"
"wuyulrt"	"urwyltu"
"dot"	"odt"
"piunhy"	"iypuhn"
"nbcsghcr"	"bhncgcsr"
"dwac"	"wdac"
"ksocbkmckdssm"	"skdkobmksmccs"
"bkybfvtdd"	"kvbyftdbd"
"pvrrtlogtl"	"vllprtotrg"
"kdgzgqo"	"dqkggoz"
"ujilxjkrkycxexxtwynldugpaompedu"	"jjyxyuoduixkkcexwndgameulrxtlpp"
"vcjlfvcyjo"	"cvovjfcjly"
"keb"	"ekb"
"rhuqjtvpmijyoyropjyjklweveaiubnyevztzmlpnzglgslmmcgmuswymiyhwqxivelxmylktxcdkwubieboptwbwmlqedguwfpvitcsyfm"	"htiyjlebvmzscsiqeyxwetmdftfrujvmjorpykwvaunezzlngglmguwmywxvlmltckuibpwwlegwpicymqpyojeiytplmmyhixkdbobquvs"
"rhnbfbfqyzoej"	"hbzrnffyojbqe"
"oclc"	"colc"
"xsirkybgqewmad"	"syedxikbqwargm"
"nzirhwryjwspdymdfgwfcdavuo"	"zwwygdonihrjsdmfwcaurypdfv"
"cuwyj"	"ucwjy"
"wsdnnfb"	"sfwdnbn"
"vbufdv"	"bvvudf"
"whwdqnvxuxorsrazkhvjghncxvzzmbwztdqmscggvyngspcprylqtpovfymyaiiytdzphgflcypzrgqhxckhkbuuyaramxqgadwjfylqfsmjlsdptin"	"hnxrhhvbdcypypyidgygcbaxdyssiwwqvuosakvgnxzmwtqsgvnscrltofmaitzhfcprqxkkuyrmqawflfmldtndxrzjczzmggpqvyyplzhhuagjqjp"
"uezrlsnkgmhzbawwgjqcyadcnigxjwzxrlkqcvhtoxlcpkkxzzu"	"esmajaiwlvxkzuzlnghbwgqydngjzrkcholpkzurkzwccxxqtcx"
"ijznlkmjazaurdnrobirbwobglph"	"jkzdbwlizlmaarnoibogpnjurrbh"
"sbxpsnjl"	"bnsxsjpl"
"dgbfdpfagqgtfrwvmdvdtqhxrjsjcnykmpxraxnsjtkwhchlmtbmrwavr"	"gpqrdqjnpxtctwdbdfggfwmvthrscymxanjkhhmbrarfatvdxjkrswlmv"
"hpqeuhgjklwsulzmswcfr"	"phllwhqugkwuzscrejsmf"
"odcefgr"	"dgocfre"
"cxrrzhlsj"	"xhcrzljrs"
"rintbqy"	"iqrnbyt"
"hkcnvdkqe"	"kdhcvkenq"
"rfkqjzfwrpfwoikorxmokfldvocswzqdcgptqnfdzjlcdrd"	"fzpixfozgnjrrkjfrfokrmklvcwqcpqfzlddqwwoodsdtdc"
"nuvuuwvho"	"uwnvuvouh"
"vizqtopzsqufnp"	"ioqpvztpsunqzf"
"lijfdiuhtxeshyeehvulzfuidarxwgmkgvheguqyosmwquqmrimpgtbayhlxzmhoipmqcppnfbxzxrjjaluehx"	"iixyvfagvusuithmppbrlxljdutehehuzudrwmghgqomqqrmgbylzhimcpfxxjauhfhselixkeywmpaxoqnzje"
"nyl"	"ynl"
"csauwujtdgwwniqesfgeyqdxingjqwafhispsbkimcfswowgzrrpdwhizludxbiz"	"sugifqnwibcorwlbcawjdwnqsgydigqahsskmfwwzrdhzuxiutweexjfpisgpidz"
"qyhzc"	"yqhcz"
"enjeqvkkammsbttcjwvwpzgxoyrkriqkgjynrwugxwcktkwibabeurmyhmxxxfz"	"nvmtwzyijwwkarmfejqkambtjvpgorrqgyruxctwbbumhxxzekscwxkkngkieyx"
"xuzrq"	"uxzqr"
"bvxu"	"vbxu"
"didxkckvtugihwggee"	"icuweddkktghgexvig"
"duha"	"udha"
"crpswalchhdhsvjkxkmrkwdwobkrkveucyadpsy"	"rahvkwbvyscpwlhdsjxmkdokkecapyschkrwrud"
"ndbxcdlvwaotlhabqlojgw"	"ddahlwnbclwolaqogxvtbj"
"xsqucwsr"	"swxqcsur"
"mxuexhw"	"xhmuxwe"
"aukmnuhvnbtaog"	"uubgaknhntomva"
"spstsbw"	"pbssswt"
"dzumrropqsdwju"	"zrsuduroqdjmpw"
"hwcyuclwknv"	"wcnhculkvyw"
"rxbfgn"	"xnrbgf"
"esgjutympii"	"stieguypijm"
"dxfyawxdagj"	"xwgdfaxajyd"
"ciqsmnfuumzwjdzfnmrugveriyvndymfxleepahkhfccokxxjmzkzlvhmhtpiznemcrhodvoqepndviztkafrricpuwlrphoosytgcjpgujshpprevwsnmcy"	"inmdmvyylafkmlhzcdevkrupscupvmcqmfuzjznrgeivdmxephhcoxjzzvmtinmrovqpditaripwrhoygjgjhpewncsuwfurnfekcxkhpehonzfclotpsrsy"
"qwkgitkpcehoxkpzfuqgzs"	"wtekusqkikchxpfqzgpozg"
"asxwfiyzpiwnttuvydxumwrroepljxeqwpgugshpheuqclhtpfvn"	"siitdwexpselfaxfypwtuyxmropjewgghhuchpvwznvurlqupqtn"
"qyycecaclslggdhrbqfbyncashdc"	"ycsdqnhqyeallghbfycsdccgrbac"
"fffujt"	"ftffju"
"tbjrbchodehmhuvwxeoltmefnwoqnecufzxnzpsliidcudxmfrblor"	"bceuemwezpidrrtjbhdhhvxotenoncfxzsiduxfboromwlfqunlcml"
"pmdesczfmefduubdvbcoaalqubelpqnmyvxzoqmiurfudxmsonramwygfyjb"	"mceubabqvqrxnwypdszmfubvcaluepnyxomufdmormyfjefddoqlmziusagb"
"mpzwsiwkrlvxbngffffbpwbdhhyxjlos"	"pilnfwhlmzswrvbgffpbhyjowkxfbdxs"
"adrysbyhaazkvvcmkodwzofbddgvcdbwafqvvroaictzumcmopckfdvqxbpbkd"	"dbavooddfrcmpdbdarsyazvckdzfdgcbaqvoitucocfvxpkyhkmwbvwvazmkqb"
"bvrlqjqrlyspxrpmaarulkvschg"	"vjyrakhbrqqlsxparlvcglrpmus"
"yabqsmoncbk"	"ambybsockqn"
"rrwljk"	"rkrwjl"
"rbubqixygkhsvdlggrmzuctzfkkppzpnksju"	"bikdrckzsruqxghvlgmutfkppkjbysgzzpnu"
"pbjsrpzetkyopuljuruoq"	"bpkurpjrztypluuqseojo"
"tczn"	"ctzn"
"wdte"	"dwte"
"cauhf"	"acufh"
"zkcmbqxvtakyzistdidwdrrifutuvoufyrxsoohuegjklnirtdnkrcxotqskqkyquymsperuucl"	"kqaiiruorogndcqkyeczcbxtkzsdddrftvuyxohejlitnrxtsqyumprulmvytwiufsukrkokqsu"
"phqpx"	"hpqxp"
"bzjylzcdixiog"	"zzxbjlciigydo"
"kuxklgzlnqvhwrwijliqefzdysyywhgvhlbse"	"ugqrlfshlkxlznvwwjiezyywghbeklhiqdyvs"
"iehrlpuvxhrrfccqqtuvevdemjooxnjymeuxea"	"ephctvjneaihluxrfcquedmoxjmuervrqveoyx"
"sgfljfkwycpzpfvymnoufsjpxcgsaswgfujintiwoevmbghgsvvcgrcxtgpb"	"gfcfnscsutegvrgsfjkyppvmofjxgawfjniovbhsvgctplwzyupsgiwmgcxb"
"avo"	"vao"
"jlofzpvoxikashkhboczrpbkfoxkrxgmjsevlqbwjftjmvcatfngvzyhydkdhfrnjrqysfuofvkfqgnhosppioes"	"lpihopoxsqfvfzdfrfvgsojozvxkskbcrbfxrgjelbjtmctnvyykhrjqsufkqnopiefoahzkkmvwjaghdnyofhps"
"pkdyp"	"kpdpy"
"yyzg"	"yyzg"
"ucik"	"cuik"
"dsdqvrsykpytespzkitaldupvfkfzpjblbatveaoyamgzyvdoqfxqkssydsfwlaqqqhwusoqihxeil"	"srpsidfpbeayqkdlqshlddvskyepktluvkzjlavaymzvofqsyswaqhuoixiqytzapfbtogdxsfqwqe"
"tqemhtdcouhdmsciddcewqsuzoobqxtfliucillyaxifgmmgwcvzenpc"	"qtusdqoxilxmcntehdohmcdcwszoqtluilaigmwvepmcdieubfcyfgzc"
"trg"	"rtg"
"njk"	"jnk"
"otyayhxxsjsyfhckoelaywigxnalthmwmbdxxsphbyva"	"thjhewnhbsyoyyxssfcolyixatmmdxpbvaxykaglwxha"
"vjqaddb"	"jdvqdba"
"lgjqlliynqlliwxrbuqxd"	"glqwuljlinlixbqdqylrx"
"aupgzjglfzooopklacerznlzroedbiaubyytzkibeataljyrpirkwwflwvasygblcyzggrjbblovmklqk"	"ujzpcnoiykajiwvgyrlkapzgfookaezlrebabyzietlyprwfwaybczgjbomlkglolrzdutbarklslgbvq"
"inuxlltdahmqpekzqh"	"nlhehiultampkqxdqz"
"errqqrfepcdoqanbklzsmritaihwowuabjhimqjcbpjzlqhcokapgzujte"	"rrcalriwjqpqkzeerqfpdqnkzmiahoubhmjbjlhoagutqeobstwaiczcpj"
"xjugjqkas"	"jqxujksga"
"esfjuqynmlrfeuzcnfhfnqlzx"	"sqlufqefuymreznhnlxjnfcfz"
"ozuspzxqtcsighmqsncezfwigvzpdpwsfxlzshawicyxunyurvjvmxvjdfrylaqrivrkgbricvbvsjjmpxcfpslsbwk"	"zzchnfvpxhcnvxfavbvjxswoupxtsgmsczwgzdwflsaiyuyrjmvdrlqirgrcbsjpcplbksqiqeipszwxuvjyrkivmfs"
"okrfsfdyrx"	"kfxorsdrfy"
"vcnlvvikgayvtlg"	"cvalvnvigytglkv"
"ldyeal"	"dllyae"
"kgwmxfwgkfx"	"gffkwxwkxmg"
"uyoknnyjp"	"ynuonypkj"
"tczgswwlaonrphxkkzjzjohzhsqqtgbzxehoyfprjpbacunkywajybwdgpglqlhaogznhkyhsdaphkxefsemrnnlfrvwsdhnoejtoqhrsxdbebhrnycmibswgh"	"cwohzosgefpuwbplgkdksnrdeqxbybhtzswanpxkjjhhqtbxhypjbcnyaywggqhozhysahxfernfvshojohsdehncisgglrkzzqzorakjdlanhpemlwntrbrmw"
"irkyvueghjueibhgbrfyhugqgk"	"rujbrukikvehuihbfhggygegyq"
"ypcwksku"	"psyckkwu"
"vfzzcvyrzkcdfu"	"fvkuvzcyzcfzrd"
"luxmcjlqkkuvetyxsukcosxrmarl"	"ujktusalxclkueyskoxmrmqvxcrl"
"iiozk"	"iiokz"
"czttmhbtyvqmrcupyftla"	"zhvcfctmbyqruytattmpl"
"jnfypdnaboiob"	"ndojfpnbibyao"
"hibatjg"	"ijhbtga"
"tnvioznurlkwawryfyiuvzlxldyv"	"nzlwyzdtvonrkarfivllyiuwyuxv"
"uuiw"	"uuiw"
"ritwywbcxzphpidupeozzhvnrsstrkvarvfgiirhldxzsfmydgxktimyjn"	"iwziehskvidfginrtybxppdpozvrsrvrfirlxsmdxtmjwchuzntaghzyky"
"sjomcbnrjmagqnktaic"	"jbmnisocnjaqkacmrgt"
"fggotfufsabx"	"gfafgtusbofx"
"fmaiiphqyobjxwxdczgaxjzaixzlxicwajqegdsmfhwzzkee"	"mpowzjxijdhkfaihybxxcgxzizxcaqgsfwzeiqjdaalwemze"
"sqcvcdw"	"qdsccwv"
"hvvsdbsidaxstmgakieqbkcze"	"vbamikhvdsdxtgkebcesisaqz"
"rcuhrrhlphuonrwzkkcbiqwrdzqpzuyqhissneohyqkwafjbaptwjv"	"crhrkqzuieqfpvrurhpunwkciwdqzyhsnoykajatjhlozbrpqshwbw"
"iwuurf"	"wfiuru"
"fdtlvadajsmhocg"	"dascftvdjmoglah"
"kfdyjlemccueiswcyumx"	"flcsukdjecuiwymymecx"
"iroi"	"rioi"
"iqswypbvtngjgyylrbdajqufebiucuvocwnwrdph"	"qpnybqbuwdisybtggyrdjueicvcnrpwvjlafuowh"
"xkojoqjoutyqlhahzbkt"	"kqthbxoojuylazkjoqht"
"hgqmbgqo"	"gghqbqmo"
"dwmttbqzulaetexuzxxifsqwafimpyuzeeqawrqcsnlwgmdoeo"	"wblexsfyernmodmtquatxzxfqaipueqwqslgdetzeuiwmzacwo"
"xqdxtyasysulvynwixhcakyhkqbhonbkywhtdhoyyfzaegetrdtxcalnmvmw"	"qysyxkqnwhfgdavxdtayuvnihaykbobyhdoyzeertclmmxslwchhktyatxnw"
"xbrkaitosbdwkjtjthpfpizjydxfjkmgdtdhqfmfkqvudscmf"	"bibjhidktfqsxratsdkttppzyxjmddqmkvdcfkowjfjfghfum"
"goa"	"oga"
"ddykvnlkmwpjguouzmbzzgskxpvjhyidpmw"	"dnwumgpymdyvlmpgozbzsxvhipwkkjuzkjd"
"tprixthylwbmiqumwsbdjxcnewywhzgocguhgyvpjrpsrjetbo"	"ptwqsxwzgyrjotrxhlbiuwbjceyhgcugvjprebiymmdnwohpst"
"fmvikbbxiwkwsglsvjpbwgmfipadhswlaxlmjsoszvxaemftkcxvqoziwq"	"mbwgjgpsxsvmcoqfvkbikslvpwmiahwaljozxefkxqzwixwsbfdlmsatvi"
"aenmnpdattzmiiqjtvyaejaonbctaoodpgbvoyjursfxtgusxptbnvsu"	"eptivjbogysgpvanndtziqtyeancaopbojrftuxtnsmamjaotdvuxsbu"
"cwhxtboitzmtlnpdczlvvbmjgqfomkcnqnudqqdkbgfqhngixjtwlcrjopahnh"	"wbznzbqknqgnjcphchtotmlpclvmgfmcquqdbfhgxtlroanxitdvjondkqiwjh"
"xuiarjr"	"ujxirra"
"wkozyvaua"	"kvwoyaazu"
"rbwrve"	"berwvr"
"ycjjwcwsrqdyvomnumwjyupeavanm"	"ccqomuvyjwwrdvmuwypaamjsynjen"
"oufzmhxze"	"uhofmxezz"
"wkxfttsqltqpbw"	"kttwwxtslqbfqp"
"pvxhmb"	"vbpxmh"
"zdakpqlnnbfdqsujvoot"	"dqbsozaplnfquvokndjt"
"rtxlslsbofascvgcdzossjkhetqcjskndbyi"	"tlfvzjtsbrxssoacgdoskeqjkdylbscshcni"
"whgnnwwlqdvzx"	"hwdwgnwqvxnlz"
"ynw"	"nyw"
"lpxzrij"	"pilxrjz"
"kxgpubjhhioljczqwoqpmvadmughnetquqvcovflcxgnufay"	"xbicovueqvxfkgujhojzwqmamgntuvofcguaphlqpdhqclny"
"skk"	"ksk"
"dwdnqsjewvpvesyrogqaz"	"wsvsgddqjwpeyoqznevra"
"sgtk"	"gstk"
"znvlgawy"	"nazvgwly"
"clvzku"	"lucvkz"
"rnxyzdwtga"	"ndarxzwgyt"
"yndrtv"	"nvydtr"
"rmxmyeprqmhtevfcjeob"	"memverxypqhefjomrtcb"
"tdeeqgkrradckumbvlgqn"	"dgaulteqkrdkmvgnercbq"
"jvzpbzabchwbvyp"	"vzhyjzbacwvppbb"
"xnnkiuht"	"nuxnihkt"
"oamsumggnxeknaxraizmammzcchtccgswxysgnghhvllgsqxfbnwknzbmr"	"amxaimccxnvsbnromugnenxazamchcgwygghlgqfnkzmsgkrmztsshlxwb"
"hchniyyfcbgnwymvilgemkvblqmxirzsiqnkdzlqtypjgnjjbmotfwfpslksnpjzqztdwzxljlydzfvaxqrawppfv"	"cybylkqrqzynmwlpzzlfqphhiycgwmigmvlmizindltpgjboffsknjqtwxjyzvxrwpvnfnvebxskqjjtpszdldaaf"
"dtjxhjy"	"tjdjhyx"
"iascdmr"	"amisdrc"
"pojsdawjvakttthhrmagpfntf"	"oaatmfpjdwvkthrapnfsjthgt"
"xxzgpnjfzpsrqrvaauxfqdemluqducmseckpxmmmkfd"	"xnpruduccmfxzpjzsqvaxqelqumekxmkdgfrafmdspm"
"dsxiwocczkmarzkaylmhmikafgetxcztrmgxstaylhonnchlxvmbooxndpsiqyuzryhr"	"sokzligcmthcvopyydxwczmrkymmkfexzrgsalonhxmoxdsqurhicaahattxynlbnizr"
"akktyhl"	"khakylt"
"hrxbpqsehuip"	"rquhxpshibep"
"ihr"	"hir"
"mxligbwispxayosqvabqypntdeejaq"	"xbpoapeqmlgwsxysvbyndeaiiaqqtj"
"zrppxcexdrotjphuqpylrl"	"rcrpplzpxedojhqyrpxtul"
"xzngdi"	"zixndg"
"phonoh"	"hhpoon"
"srjgzsyszuzdjmsnzwckemqxpxhqodfgrkqzncfbh"	"rsumwmxdkcsjzyzzjszceqphofrqnfhgsdnkxqgzb"
"hkg"	"khg"
"hfb"	"fhb"
"ltqaaqvikliclqgknrfbsloxtzotnsscobgfwyzwtssqdeonvcuvlfpjwuujsecoc"	"tqlqrlzsbysecfuelqavkilgnfsotonsogwztsdovulpwusccaickbxtcfwqnvjjo"
"huogvfothaa"	"ufahovohagt"
"xoowthvxo"	"ohxotvowx"
"aoaebuduxhrwglitshwccxzgjpifhjabhvsplokmughbo"	"ouhlhxpjvogaabdxrgiswczjihahslkuhoeuwtcgfbpmb"
"xajjonfkttysdi"	"antixjoftydjks"
"qgjonntgyxpdwgciogjcocohipewrgvfvygbddnj"	"gnxggcpgydqjntypwcojooiervvgdnogdichwfbj"
"enifzkpj"	"nkeizpfj"
"gycgbmuglrfyqsfdwr"	"ymrsrgcbulfqfwggyd"
"cqfeshr"	"qhcfsre"
"lpjiudzyvtbawjvldozar"	"pdtjoljuzvbwvdzriyala"
"vsywaqixegclvczqz"	"sqgcvyaiecvzzwxlq"
"scxxucunkzn"	"cczsxuuknxn"
"detvksztejgnaociggicpwl"	"esjogwdtkzegacgiplvtnic"
"kkktovrjpw"	"kvwkkorptj"
"jgyoib"	"gbjyio"
"gsgz"	"sggz"
"cdbrobbntddcjxfucdfgsonwysrowxuonphhodfsrnqjxvsrmzvzaqfbicsvbffczmwqwxdbrvogvkjd"	"dbdxdosxpdnvzqcfmxvkcbobtdjfcfsnyrwunhofrqxsmvafisbfzwwdrovjrncugwoohsjrzbvcqbgd"
"pffmmifhkibhhb"	"fiibpfmfkbhmhh"
"ypbolwsagdedlwylsfklbqrauvbk"	"pwdwfqvyblsgelyskbruboadllak"
"dnemjy"	"nydejm"
"clstiodkgub"	"loucsidgbtk"
"wwbwmsuccbopwmrkpierfcvs"	"wsbmicwbmucowrpefvwcpkrs"
"xivgutpsmgoikm"	"itgmxvupmokgsi"
"enpvpwimxsbntegerdapddhraojxekqvchmnimqnwpim"	"nwseddokhmpeppixbtgradhajeqcmiqwivmneprxvnnm"
"czllxc"	"zcclxl"
"cfcjmocscbhtcfsmuuhrkusnichmts"	"fobfuucsccmcchcsuhksihtjstmrnm"
"vydrufredcszhvyvgoioprrfywrsja"	"yfcvorwavdurdshygipryrjrezvofs"
"spwkavgdqakn"	"pvaswagqkkdn"
"vnkpgufhmlgvyhigbanovu"	"nulhauvkgfmgyibnvphvgo"
"epnmnjfeychwpg"	"pjcgennfyhpmew"
"fgnmlkwrfwhc"	"gkwfnlwfhmrc"
"cvqyliomovnrjjvgliwnbluvaokjcpflarzpkrfcqfqmczbgvktzttzfybhvyjythrsageqmlfyixzbcjltnhor"	"vivjiloprrfzktbjrefzlocqloonjvlwbuakcfazkfqqcbvttzyhyyhsgqlyxbjthrymrgnvjlpcmgzfvtamicn"
"oojogs"	"osojgo"
"pefp"	"epfp"
"sfjgwmrsxigkqp"	"fmipsjwrxgqgsk"
"ckzwkwrovyhpoamfrs"	"kwyasczkrvhomrwopf"
"uoisgdjutbxrttaczgvhbdlqmafhapdrotbnkybeu"	"odbtgdaptyuigjtxtazvblmfadobkbusurchqhrne"
"vyhnkn"	"ynvhkn"
"tvyyvxvcrwelnnatmbpqcafef"	"vxwnbatyvvrenampcffycltqe"
"krlwc"	"rklcw"
"vfolxvhwn"	"fvvoxhnlw"
"hnxnh"	"nhxhn"
"gjnpxmayrpiqmysbumfleuvhro"	"jmpymuognxarimsufevrpyqblh"
"djq"	"jdq"
"jvnvro"	"vojnrv"
"hlnagkcezlwhssbgks"	"lklsshngczwsbkaehg"
"odrzrlmzrrdztaqbscmgbcmydafohlp"	"dlraccalorrmrdtqsmbmdfhpzzzbgyo"
"mqrkpthaoiomknhpefzwxwuysgdwowhthill"	"qtinfwgwimrphookhezxusdohhlkampwywtl"
"bsnaysy"	"ssbnyya"
"krdrritxahugnfgbc"	"rihfkdrtaungcrxgb"
"ukuvtezpvxssutrtfcqwuyzzjmctfmxyqmguzuubaneqafwaokojikjcmjmfxwusqrvzstbxtrbcznsuftvridftgbrn"	"kextcymmmunfkkjwrtrntdbuutzvsurfquzjcfxqgzuaeawooijmmxuqvsbtbzsfvifgrvpstwztyubqajcfszxcurtn"
"dmspkogk"	"modskgpk"
"syphwfruksn"	"yfsspwrknhu"
"zdoxssqgmsk"	"dsszosqmkxg"
"dgpvhh"	"ghdphv"
"ihrgheedfynwpnthwfjaokkroyaoeenunywsxdvzvdvbyulkvabzbdyjofubbsrpezcmhe"	"heynfkyeydduadfszeirhefnptwjokoaennwxvvvylvbbyoubrechgdwharouszbkzjbpm"
"cnqcrbigtbvwwaoqm"	"nbbacqritvwomcgwq"
"pigizy"	"iypgzi"
"yqzxqwqqxflf"	"qwfyzqqxlxqf"
"vkbcqix"	"kivbqxc"
"ogeuhzp"	"gzoehpu"
"bfgp"	"fbgp"
"sevwfsjesvjobqrk"	"esvqsvfjsjbrweok"
"kacps"	"akcsp"
"vucfhuxeyvxokdlghviyjyywgqloqkzdfpqjotqqjkgxhdaov"	"uuvdvyqkptkdvchxyxklhijyglqzfqoqjghavfeogywodjqxo"
"qyiqaqqljeqqbjwgpassbmxzmi"	"yqejamiqiaqjqbwpsbxmqlqgsz"
"foyvngvmbvjmvcdczjkladsdxnfytpufmshtgeurush"	"ogvcjdnpsesfynvbjvdzkasxftumhguuhvmmcldyftr"
"eluaqujfoghene"	"lugeeuqjohnafe"
"tmglhbtjl"	"mbtghtllj"
"cojv"	"ocjv"
"uveeuxtzvenwqwuxayskfuzredhapyvojaupxfqtpdkshmpauftpncdqubwfnzp"	"vxewyudyafdmfcbzueutvnquasfzehpvjuxqpkhputnduwnpezwxkraoptsapqf"
"amofnfcjypsuoxq"	"mfpxaoncysoqfju"
"glfhhgfkdpzdmzanfuawiaenzdfditntklxybwxixiglkztuztgwqynjrdmzil"	"lgpzuadtlwiztydlgfhfdzmafaiezfinkxbxxgktzgqnrmihkdnwndtyiluwjz"
"yofwvbkrewmgjrftnahnadnxlzrbkwpkgetohmxhkcymfbggvyphejsqvrixcsbith"	"obwradzwemcbyjrshyfvkemjfnhanlrkpgthxkyfgvpesvicbtwrgtnxbkohmghqxi"
"wopnobpvpzccg"	"obzwpoppcgnvc"
"qieggsilafwgrhtxxfdqzuzp"	"isfhfuqegiawrtxdzzglgxqp"
"inowtpdlinpqynj"	"npnniotdipyjwlq"
"pokr"	"opkr"
"inlfmiwmaohdytnmhzk"	"niotzilmwahynhkfmdm"
"bwgndtkrgprjrxkqyamtfnlgthftbdmkxqwtncejsjuzmvytpxrsgbtnqdmfbowrpoushgkgngwo"	"wtpxanhdqcjvxbdooggbgdkgrrkymfltfbmxwnesumyprgtqmbwpuhknwnrjqtgtktjztsnfrsgo"
"vlrzvdmguofycqrt"	"ldoqvrvmufcrzgyt"
"zhgyjy"	"hyzgjy"
"edc"	"dec"
"zpoigqi"	"pqzogii"
"hhorlyqcwfp"	"hyfholqwprc"
"scdngcibdpwgsbntrhinqygqeasvsyrcmelvwzto"	"ccpbhyayezsdgidwsnriqgessrmlwtnbgtnqvcvo"
"asysrctmkwsexbdmetudphcpwskta"	"scwbthsayrtksxdeupcwkasmemdpt"
"hsnnnvlsqmxbweqnkksdcfnulfqpi"	"svmekffhnnlqxwqkscnlqinsbndup"
"jsoqzo"	"sojozq"
"bzimi"	"zbiim"
"uojxtvi"	"ovujtix"
"gouwozgcwxrgwxzwm"	"ozxxguogwrwzmwcgw"
"dkegcqwtu"	"kqdecwugt"
"yklkqw"	"kwylqk"
"sgau"	"gsau"
"adrowvtrtvmzun"	"dvvnarwttmuorz"
"fvfpjloqsqqfkyk"	"vlqyffjosqkkpqf"
"cviyymsdncylkyyedvttjsuuqkbvdzjqrhyfqyzvdgqfywaqbtzzfansritndnitfjoqphwxhalkrtgygvgbjnbyezfddyrjsvqmlczyxislskavfqkbolxxhtgnti"	"vmcyvskzhygwtainjhatvnzyvcikqlticiysnykydtjuqbdjryqzdqyabzfnrtdifopwhlrgggjbefdrsqlzxssafkoxhgtydletuvqfvfqzsntqxkybydjmylvbxn"
"rdhnvymnovegwnppqpchrfvqwtnnbp"	"dyvnpftprhvmoewpqcrvwnbnngphqn"
"toqqyeshp"	"oetqyspqh"
"qfzyfuiajteaavwrmz"	"futvzqzfijeawmyaar"
"iwbbmketdchmlaixjvirgbr"	"wkcavbibmedhlijigrbtmxr"
"lrwjognkugeahzuolbcr"	"rggzblwonuehulcjkaor"
"zlonsrbdncyknraliaffyqdjmmxzqnluvohgnilelouhjktpbkhemxcwjjackdkzaiizatsopdrgkpjmkschdagaxcjtsztfavptmfpmvwaotxidkepduuso"	"lrcraqmnoiokkxjditdpsaczvfwxeuzosbnynaifydmxqlvhnllujtbhmcjakkaiasprkjkcdgxjstapmpvatikpusndklfjzugehpewczzogmhatftmoddo"
"ymqnv"	"myqvn"
"tcclwzc"	"cztcwcl"
"vgkk"	"gvkk"
"nqxhepukejuqxmjzpioquauvdcusxdwalvjjszscpf"	"qpjmiacdvzfnxeueuxjpouuduxwljssphkqzqvsajc"
"eztradrotuntaqakrurqshxj"	"zduquhetartnaarrsxrotkqj"
"nfhbzhbjkxlcrjrcbztgxvzzurzgtkpnx"	"fhxjzvrknhzbklrrbtxzuztpxbjccgzgn"
"fvktfbswvscmronroegnuyvontqjvqvfoioay"	"vbsoeytqifkfsvcrnoguvnqvvooytwmrnojfa"
"zyrnfgvjxtalhdesptejnokzs"	"ygtdtozrfvxahepenksnjlsjz"
"eydwlabgksqvvxgxk"	"yasxedlbkqvgkwgvx"
"eiri"	"ieri"
"aqslinl"	"qnasill"
"liioc"	"ilico"
"alckmk"	"lkacmk"
"ameeesqpt"	"msaeeqtep"
"nyjpeuirmmrubfshbaxpaglguzfdslarbbpnwcronkdbdileopglignpdfckqwutynhuzlpowaunhtcherssptgburgoyohmgplimcthyxhblsjg"	"yumfagzlbckipgfwnlatrtropcxsnjeimrbsbxalufsabpwrnddlogindcquyhzpwuhcespgugyhglmtyhljpruhpgdrnobelpktuonhsbomihbg"
"qzoiymuvmpdss"	"zmpqoyumdsivs"
"vhbk"	"hvbk"
"hjchkbftffrieaawgsnz"	"jbfashckffreagnhtiwz"
"cwkjqoorxylmufsourcthepjthl"	"woyfrehckqoxlusuchptljrmotj"
"urkqbpdzodvn"	"rpdukbdovqzn"
"hxmkdwqvslhgugascblmnktptpbecmwlxcitmjwgkaz"	"xwlgbkpmcjahmdqshuaclnttbcwximwkzkvgsmpeltg"
"jxjvxp"	"xpjjxv"
"omxpifd"	"mfoxidp"
"rqhahrlwx"	"qrrhhlxaw"
"ouxnskkm"	"ukoxsknm"
"ahkogypiwiufavhqyquljwqkvlrovufeubzsdtyrpcnka"	"hyivqwlubtcakgpwuahyujqvrvfuzdypnaoifqlkoesrk"
"zdcsrbouizlup"	"dbzzcroilpsuu"
"qjvxqzbrjnd"	"jznqvqbjdxr"
"efkwjihndzvoq"	"fizekjhdvqwno"
"gzko"	"zgko"
"zjdqkvvoityfwlg"	"jvtlzdkviywgqof"
"mbuepkzsayxdnqvhyjwwlqmbmkkacdudryeyuxcjqgnyz"	"bkyqjqkdyxgmupzaxnvywlmmkcureucqnzesdhwbadyjy"
"gyr"	"ygr"
"wbdipnemrgdcwvqnsnifrndwpqpuvsejynekqet"	"bngvnnqsnewdperdwqsirdppveyeqtimcnfwujk"
"puhtihk"	"uhphikt"
"tqlijhuajnoe"	"qhntljujoiae"
"ymnovphaomnyendfomildhpffsyzxtxrichvameywfrfac"	"mpmnmhstcmfcynvhonedoidpfyxxihaewraoayflfzrvyf"
"oeswnkvsfpcjeo"	"ekpoosnvfcewsj"
"ptxcy"	"tpxyc"
"gxcxemfjox"	"xmxgcefoxj"
"xkmnk"	"kxmkn"
"ptknyphbicepx"	"tpcpkyhiexnbp"
"gfptppdfsqwnmdscnukrntoggpaazeeyhgejqbajjdpoqrqimfagahiylguptux"	"fpqdutpegbdrfhgugppdswmsnknogazeheqajpqqmaailutxtfncrgayjjoigyp"
"hsenjutzl"	"suhejtlnz"
"qfljlxflyrjyitzhaqkj"	"fxrtqqllfyjizakjlyhj"
"zzlahtbkbpfctnkiujxlapind"	"ztpnjpzlhbbftkuxaidakciln"
"glqrqwvdi"	"lwgqqvird"
"qaqtbbcptzn"	"abzqqbctntp"
"uucqhzonezaxaehwvgrenvqkxlcifujrgumjdsimaahpwbchxgythqzjd"	"uzzegvluusabgquchoeaahvrnqxcfjgmdiahwcxyhzdqnxwekirjmphtj"
"fhmxlujskgvphtebaqckvfvrydkfvixyfniicabkvu"	"hugtqfdinaufmljkvheacvvykvxficbvxspbkrfyik"
"ehkdyl"	"hlekyd"
"vfr"	"fvr"
"gbavqdfarytuyxhvdaikocqkshgxjpsdqaooljixxu"	"bdyxachpajugaqfrtyhdioqsgjsqolixvauvkkxdox"
"bfchehdujgukurlpmwgvolhvlkh"	"fhgrwlkbcedjuulmgohlhhukpvv"
"uwrclqkyknxtfxbyzdseeddcgzowjspq"	"wqnxddzsurlkkxfbzsedgojpcytyecwq"
"vqktpnne"	"qnvkpnte"
"gww"	"wgw"
"xjmj"	"jxmj"
"jfiybyitaialntviuupdgthfgaclzjzzwtqqqvxzzvlvbisiuqguvnjksxceiqorwfcbcjdxviugjxydvopuqoyihypivokpnngnrdgfrsyzlmdxr"	"fyitutajtvviqnxqfjixooyondsmjibiaanvupghgczzwqqxzlbsugvjsciowccdvujyvpqyhpvkngrgryldrytlidflzqzviukerbxgduiipnfzx"
"hzjhktkjqiwryuylgsdfnhslcisfget"	"ztiushiehjkkqwyygdnscsgthjrlflf"
"yhzvmmzckrwk"	"hmryzmzkwvck"
"pjohiwrxaqbmnwlkbleszufdxpdwqbpsjicupxjufpbgiiintiyvokp"	"jwqwlupbixpiikpoirabnlbezfxdqpjcpjfbiityophxmksdwsuugnv"
"pdln"	"dpln"
"wjljxiecmzpjhdeaqedbjlabovextkkaqaftkkbwbaehae"	"jizdelvkakaewlxempheqdjaoetkqfkbbeajcjabbxatwh"
"gximqhitsotdewnddnbxaaaeekhbssfwdrrtrqmqg"	"xhownaksrqgiqistendbaaehsfdrrmgmtddxebwtq"
"hfctfhw"	"fhhcfwt"
"ruaecq"	"uqrace"
"ntisqub"	"tuniqbs"
"aozti"	"oazit"
"mxwtz"	"xmwzt"
"odv"	"dov"
"libmumzqddtkcukmbsjeozihpld"	"imduszllbuzdtckbjoipdmqkmeh"
"jewfvdjrbkrumrodzisvbjiyknpg"	"edkrijnjwvjbrmozsbikpfrudvyg"
"zsggcx"	"sxzgcg"
"yzbadzezcmfsbcpftnpfmeadccaoiyknpfmcqghpasfoqqytmnojbuoqloroawrfmxb"	"zzmcnecyfgsqnuowxybdecfbptpmacaikpmqhafqymobolrarmbazsffdoncpotjqof"
"azfe"	"zafe"
