string[A]	string[B]	int
"k"	"sitt"	4
"Saturday"	"Sunday"	3
"kitten"	"sitting"	3
"GCTACACGCAGTTGCCTCGAGGAAACAAGCGCAATCGGATCGCGCATCCACACCACGACCCTGTAA"	"GGGGATTCGGCATGGCGTAGGGGAATTGCTGAACGACACTCGTGCATTTAAGGGGGAACTATTACAG"	35
"TTTACACT"	"AGCAGTGCATTGGCGGG"	13
"GCTCCCGCACGTCCCC"	"AGTCCCGTATAGAGACATACGCAGAGGCATAAATCCCAGCTGTATTCTCCGTAGAATGCTACTGCG"	50
"GGCGCGGGA"	"TACGGGCTGCCTGGTTAAGGAGTGTATAGGAAGCGTTTCGCAATGTCGAACAGGGGGAGCGCCTAACATAGGAGAGATCATAAACGGT"	79
"CTGACGAAGAACGATCGAGTAAAGACCCGAGTACACTATGATTCATAGTGGTG"	"GAGTTTATAATCACCAGTGACTAGTCAATAGAACTTCTTCTCGTATAGCGCAACCTACTTCATTCCCACGTGAAGATGCGCAG"	43
"TGTCACAACTCACTCTCATCGAGCCCACTCATTTGTC"	"GTAGGATATCCTCAACGCATCCTACCTCTCAAGAGCAATTTGCGCCT"	24
"TTCGCCTAGGTTGTAGGTCGCGATAGGCAGTTAGACAACGGGGTAGAGA"	"CTCATCAGTCGAGGATGCTGAATGGCCTCTTGCCGCAGTTTAAGGAATTTATTTGGGTAACTGGGCTGTCGCCGTAGTTACTACTGTAATAC"	50
"TATCGCACGTTATGACGCGGA"	"ACTGCCGGGTAGCTCGTGCCACGGCTTGGAG"	17
"GCGTACATTGGCACGGAAGTGTGGCCCCATGGCTACGGGACC"	"CCGATGAGAGACCCAAAAACGCGCACTGTGTGAAGTCGACTAAGCGCTGCGTACGAAAGTGAGGGCGTAGGTCC"	41
"TCTAAATACAATAGCCCTTTCACCCTGAGGAA"	"AAGAAAGTGGCGTATGATACTCAGGGGTCCTCCATCGAGCGTTAATGACGCGTCTGT"	35
"GCTAAATTGTATAACGAGCATACGTAAATAAATAAT"	"ATCGCTATTCATACTTCGACGACAGTAATGTTACATGACACCTCACCTTCGAT"	28
"ACAAGGTACGAGCATCTGGGGTTACCGCGGCGTTGGAAGCCCTACCTGTATGACGCATGGATCTCTATACGCA"	"GCCTGATCTACGGACAGTAGCATGACGCATCGCGATGTGATTGGATGGTCCGCCCCAAGATTGGACGGGCGGCTCCCTTGGCCT"	42
"CAGTGACCCTATACGCTTGGGTAGGCTTGTATTGCACGTA"	"ATTAGACAATGGTCCAAGTGAAGAGTATATTATCGATTGTTCACATCAAGCGGTGTCGCTGCTAAAATAGCTATGACTGCATTCCAGACTTTGTTCT"	63
"TG"	"ACGTTGGC"	6
"TG"	"TGTTCAGGTATCTGCTCGACAGGTCCCGCGCGCCAACCG"	37
"AACGCGATGCTCATACGGA"	"CAGACCAAAGGCCGATTGTTCCCACGGACCGACCAAAAAACCTATTTTGTCTGAATCGTATAGCTGCTCTAAGTAACTTTCGTTCTCAAC"	71
"CGGGTAGGTGGAAGACAACTGGCT"	"AGTATATGGGTAGAGAGCAGTATAAGTCCGGCCGCGGCTCT"	22
"ACAATTAACATCGGGT"	"TTACGGATCCCGGAAGCAGGTGG"	14
"AATGCCG"	"GCTCATGCCTTTTTG"	9
"CCTATGCACGGATCGGGTGGGATATCATTGTCACCTAAT"	"CGGCATTGGCTCTTGACTAGTGAGGTTGTTAGAGTAGCGCAAAATG"	23
"AATTGAATTTACCATCCCCTAAGAAGAACACCAGCCGCGACGCAGGTTTGCTGTACAACCGAGGGTTTGAT"	"TGCATTTCTAGCCACAGTCTACAGTTGCGGCATAACTTACAGGCCTCTCACCCTAGCGATCCAGCATGAAAAGGCTAACTAGGCAGTCC"	49
"GGCCTCCGCCGCTCATCAGGACTCCACGTGTATGCCTATCCAACCGGGGCCCGGATCCA"	"GATGTATGAAGCCGCAATGGGATTGGTATCGACAGGGACGATTTGGTGGGCCGGGCCACGCTGAACGGTACTTGCACCGTTTGAGCCT"	48
"G"	"GACCAGTGATTTTACTCAGCTATTGCGG"	27
"CCGAAGGACG"	"TGGCGTCATTCCTGGGTCCATATGATCCTGTTCAGATTACCCACTGTTTGTTGCAGCC"	48
"TTACTCCTGCGAACCTTGCTCC"	"CTACACAAAATACCCAGACTACGCGATATGCGACTAGAAG"	24
"GCCACTAACACTC"	"TAGTTCGGCAACGATCACTCATAATACTCCGCCCGGATCCTTGATACAC"	36
"TGTTATGACTGAGAGTAAG"	"TTAATAAGACTCGAGAAGCATGCTTCACCGTGAAGAAGGAAA"	26
"AACGGAGAGTTAGTCAACGGCTGCACCATACTAAAGACGGGACTAATACAGATCCAGAAAGCT"	"GCATCCAATGCCGCGGGCTGGGAGCACCGACTTCCGACGTTTCACTCTGGATCAAGGCTCTGGCTTTTCGT"	42
"GCCAAGCGCGTCGAT"	"AACTGTGGTAAGGTCCAAAGACTGAA"	17
"GGC"	"GGAATTGACCATTACGACCGTAAAAAGCCTATAAATAGTCTA"	39
"AAAACCCGCCCCTTGGCGATCACCCCAGCCACCGCGTACCTAACAGTCTTGGAATCCTTACACAGAGAGACAATCAAGT"	"TAAAAATCCTCCGCAGTGTTCTCCTGAAGGTGGTGCAGACACGGAGCTCGTAAGCACCATTTAGCCTCTTGTCCACTCCCAGC"	47
"GAATATTTAACCTAGCGAATATTCGGCCTTAATAAATTTT"	"TGGCCCATCGTCACGGTTTCCTTCTTCCCGCGTTTGCTAAATTAGAGATATCTCACGCGTTTACCTTACAGTTATGAGGTGAGGC"	53
"TT"	"ACTTCG"	4
"GCAGTTATCGTTTTGTA"	"CCCGGGCAAGCCTATCAAGTAGGCAGG"	16
"AAACCGATTAAGCCACGCCGAGGGTTGAAGCGGCTTTTCTTCACAAAGTTCTAAA"	"TTGTACGGTTACTAGCTTCGACCGGGAAGAAGTCATACAAGGCAGTCATACTTAAAGAGCAGTATATACAATGCACCCCG"	43
"ACAACGGTA"	"GGTGATGAGGAGCTGAGTCCCTCATCTGTCGGTACAATAGAGCCATCGTGTGAGCTTGATTGATCCTCCTTCACGAGTGAAACAGAAGGAAACATA"	87
"CACGTCTATGTAGAGTACTATAGTGTTATCTGCGCGTCGCTGTAGAAGCTCCATGGCGGGTACGGATGCATGGCCCCCAGGC"	"TGGACTGAAAACCCCGTGGCCTGAGTCGAATTGAAATGATCAGACAGGGCATGGATACAGCAAAAAAACATAAGATGGACTAGGGGACAATCATCGACG"	57
"ACTGCCCTCACTCTATTCTAGCAGAGGTCTGTGAATCTCGTAAGAAGTTATACAGTGCC"	"AGTTCATGCCTTCATTAAATTGTTTTGCATAAGATTATGCGACTAGTAGTAAATAACGCCATTGTCGTGCGTCTCTGGTCGTTGCTG"	46
"ATATCCCATGCGCGTCTCTGCGCGATATGATGTAAGCCCGTACGGGTAACGCATTATTAAATGTTGGGTTCCTATACTAC"	"GCAGGTCATCATGGCGCTCGCGTGGTGTCCGTAGGGGTCAGCTCAGTCGCATTTGACCAAAGAATGCAAAAGCTTCATGGGGGAACATAATGCTGGA"	49
"ATGGCAGAAAGCGC"	"TGTGGCGCGCAGAGGTCCTTTGTAGTATGGGACAGACTCAGCGGTCGGAAAAGTACCGGACTAGTCGCGTCCGTAAGGGCGGCCACACTCCCGTTAGACC"	86
"AATAAGGGTCCGA"	"CTGATTTGACAATATGTTGTTCTATATCCACATTACCTTCGTTATCGCGTGAGAAAATCCTGCTATGTCGGAAAAACCCA"	67
"ACAGCGAGTACCTCGAGTGTTCTACCCAC"	"TACGGTTCAAGACTTGATCAGGTTGTGTGGGACTGTTG"	22
"GCTACC"	"GCGTCCGCGC"	5
"GTACTCGGGACCTTACTCAAGCATAGGCTTAACACGCTC"	"TAAGTACCTACAGAAGGGCTAGTATACGCGTCGATGAGTTCGTTCTATATCAAGAAGCGAAACGAGCATGAGTTAGTGATACAATAAGTGGTCTACAT"	61
"ATAT"	"CGAGCAGCCGCCGTTAAATCTAGTTATTTTTGATTCAAACGTAC"	40
"TCTCGCCCCGCG"	"GGAACGTGTTGACCTCGGC"	12
"GCAA"	"GCCCATTGTTAATGACTAAGTTCAG"	21
"CGACCCAATTAATTATCCTGGTGCCAGCGTCAACCCATTTCTAGCAGGCACTATCCATGGCTGTGAGGTAGGTGTCGATAAGTAAGTAA"	"ACTTTCATTGCACATTTGGTAGTGAACCTCCTAGCATCTTTCTCCCGGACAATTCATACCCAGTCTTGGCAGATTCCATCTTCCTACCAAG"	49
"CCTCGATTGAAATCCACATGTG"	"ATATAAATGCGAACGAGCAGCAAGACGT"	16
"AAAATAGTTCGATCCACTCCGACGGCTTGCTCCTCGTTACCCCGAAGCATAGTTCGGGATTTGCTTTCTAGGC"	"TCCATAACAGGTTCGACATCGGGAGTTGAATACGAGGATGGGGATCACCTATGGTCATTGTCGCTGTAGTGCACCTACGCGGGCCGATATATGGGACGAT"	56
"G"	"A"	1
"T"	"G"	1
"TCCG"	"GGCGACGAGCGTTTATCAGTACCTTTACGTTCAGAATGAGTGACAACCATGAGTTACATTTC"	58
"AC"	"TTTTACAAGAATCACTAACAAAATTTCGCCTGGCACGACCATG"	41
"TGATTAATATCTGAGTTCGCCTTCGGCACAAGGAGAA"	"GTAAGTCGAGGCCTAGCCTTATGATCGTTGTAATGGCTTCAAATTAAGCTACTGC"	32
"TCTAGTAGA"	"CTTGCAGCTATTGGTGACCCAGCCACAATGA"	22
"ACC"	"ATGTTACAGGGGTTAAACCGACGTTGAAGCCGGTAATTAGAGCAACAGACCGGTAAAGACTTTGCAGCTCTTTGTAATGACT"	79
"CCTCTAACTATGAGTTTCCCACCAGTATCC"	"CAACTTCTGGTGCTCCCGAGTATCAAGGAATCATATCCTTTCACCC"	25
"TAGTGA"	"GGGCCGCGTTAACCCGCCACACGACAAATGAATGTGC"	31
"CATCTCAA"	"ACACCCTCGATGTAGATTTGGAATGTGAGCAGAGATTTGATAGTGTTACCGTCG"	46
"GATC"	"CAAT"	3
"CATTGTACCGGGGTTTTGACGGCAAGAAAGACCTGTC"	"GGACTGACATGCTTTGCTGTAGTGGGTACCTAATCTGCGGGTTGCCCACTTCACTGTTGCGACGAAAGTCCAGCGTATACCT"	49
"CATGTGTAGGCGC"	"CCGAGGGTTGTCG"	7
"ACTCCTAGATCGGATTCGATCGAGAGGTCTATGTGACGGCG"	"TACTTGCAGGTCGATTGCGACACGCCATTCATCCCGTACAGGT"	21
"CCTATTCAGTCTTGTCCC"	"AAACAGAACGTGCGTGGTGTTCTGCCCGAATGGTTGATGTAGACCAAATGTCTCTGGGCGCGCTGGAGAGAACGTGGTGA"	63
"C"	"T"	1
"GACTGAGATCGTTCGACTGGACAGCA"	"CAAGGGGTACAGCTTATTCATATACACCGATTATAGAGAA"	23
"CCAGCTAATTGCTTCGGAGATGTACTGTAGTCATTCCATGTAA"	"TTCAACCGCTACCATGAGACGAGTCGCAGCAAGCACGCTTCTGATAGTG"	27
"CGTCAAAAGTAGACCCTAGCCGTCAATAGGGACACCGCCCGCACGCAACCTGTCTTCTTAAGACGC"	"GCATGCCGATTATGCCCGGCGTGATGGTTTGAGCACACTAGCAAATTCAAAGTGCTCTCCCACACCCCACCGAC"	40
"GGTCGTTAGGTTGCG"	"TCATACCCTAAAACCGATACATGGATAAACGTAGTAAGCTGCT"	31
"CCGGCTCCATCTTCTCATCGCTGTGAAAAGGCACTCGG"	"AGATGAGACGTATGTAAGGAGGCCTCACAGAGCAATAGACTTTCGCCGTTCAAACTCCCCTCTCCTGTGG"	44
"GACCTATCAGTAGGATACCTAGGCGTGCATCGTATCATGAAAGCGGGGTTGTGCG"	"CGTACCCTGCTACCGTCGAACGCAAGGTCTAAGTATGCCTAGTTTACCGCCTTATTCACAACGGCG"	36
"ACCAAGTTGGGCT"	"ACCAGGCCTTCCATAGTTGGCCGTGGGTC"	17
"CGGTTCG"	"GCATAACACGTT"	9
"GAGTGCCTGACTG"	"GCACTCTCCTACGGGGTTCTAGACTATACCGTAGGTTAGGAGTGCGCCAGGACCC"	43
"GCAATTAGA"	"AAGGCGTGCGCGTCCGCATACGCAGCAACGACGGA"	28
"TGGATCACAGAAAGTGTTCGTCTACCCACGCGCTGCGGAGCACCGGTAAGGATGACTCCGAACCATA"	"GGATTGGCCCGTCTACCGTAAGCGGTTATTAAAGTTCAGACTTGCATAGCGCATTGCTGGCCCCTGGGCTGA"	42
"GAGGACTGATGAGTTCGGATTTAAAC"	"TCTGTAGAGCCGTTAATGACAGTAACAACATCCCTGCGG"	23
"AGCTGTCTTATATTAGTATATGCGGAACGAGGGT"	"ACCCGGCAGGAGCTCCTGTCTACTCTTTGATGCGAATCAAAACCAAATGAGAATTTTCCACGGGTGGCAGCACACCATGCTTCTCCCGAGGTC"	62
"GAGTACCAACTCTCAGGTTAGGTTCAAGCTGAA"	"CTAAGGGAATTCTATCTTAGCTTCTAGTGGTTATTC"	20
"C"	"A"	1
"CTGGCAGCGTGACAATTGACAACACCAATAGGACTCTAAATGGGGGAGTATTGGTTA"	"AATAGAAATCTTCTTTAAGCGCGGGACTACTACCATCGTCTCGCCAGCGCACAGTCCCGCAACCCCGATGCTT"	45
"GACAGGAT"	"GCTTAGACGAATCCATCGGGGGCCCACTGTTTGCCGTTTATTTCGTGTGCACACACTTGACATTCCAGGTGAC"	65
"TATTGCTTCCTAGCGGACGTATTCACTAAATAACTGACACATCGCATCCACCTGA"	"TAATAACAAGTGGCGACACACCTGATTTCATGATAGTTGTAGAGTGGGCAGACAGTTACGGGCGGTCACAACGATACGGAGTATT"	47
"TCAATCTGTCT"	"TATTCAAGACC"	6
"T"	"GCTAAGTTCACATTTGTCG"	18
"TTCATAT"	"GCCCAGTGTCAGCCGGCACGCTTACCCTCCCTAACGCGCGTCCCATTCTCTGGTCAGATTTGTTGGATCCAGACTGGTT"	72
"TCCCACTAGTTCCTATTTGCACCCCTAGTACCCAACTTTACCTAGTTGCATC"	"TGGGGGCAGACAACCTGGAAATAGCACAAGTTTAAAGCACCCCTAGCGCCGCGCATCCACATCTTCTAGTCTGGCGCGCATATGCTAAGACGTAACT"	53
"ACGTTCC"	"AATTACTTTGCA"	7
"ATGAACCTGGTACCTAAAATTACCAGTCG"	"ACCTACTCACTGGTTATTATTACACAATTCGTGTCGGCTGACTCCCCGCCAGCCGACGAGAGAGACCGAGCGTGTGAGCCTC"	57
"AGC"	"CCCT"	3
"TTTCGACCTTCACTA"	"TCCTACGGTTTGCTAGCTGAGGTTACGGGGGATATTCAAGAACCTCTGCACTCGC"	41
"ATAG"	"GGAGATTGAAGACTT"	11
"ATTCCGTATTATTGAAGGG"	"GACGATGCCATAACTTAACGAGGTGTTGAACGAACATTCGTCCAAGTGCGCCTTGACAGTAAAAATAACCGCAT"	56
"GGCTCAGGTCGCCTGCTGCTACTTAGG"	"GATCGAAACAGATTGGGACTTAGTATCTATAGATTGTTCCTTCCTTAAACATCGCTGGCGATC"	41
"GCCAAATTCGCGGTGATGC"	"ATGGAACGTAGGGTTGTTATGCGTTAATTGCAGTGGTACCAAACTTTTTACACTTGAAGTG"	46
"CCGACGCAGCATCATGTTTTGCTCCTTCACGTGCTTTGTGAAAC"	"ATTTCCCTAGCTAGGGACAGGTAAATGATCCTGGCATGTACGTTTAATCAATTAATTGATTCCGAGGTCATACCTG"	44
"AGTAA"	"CAACTCCCGAGCACTAAATACCATATTGTTCGTCTCAGGCCCACAACAACACAAGAAACTTAACCAATGGGTTGCTGAT"	74
"A"	"TCAATA"	5
"TTGAGTACCGTTGTGTCCTCACCTACATTAACAGCGGCTTATTGCAAACTCCGACCTCGCCCACTTAAGTAG"	"CTCATCGGCTATACGTATGCGGGAAGGCAGTTACTTAAACAACACTTCCAGTGCACTGATCTCCGCGCCGACCCCACGTAGAATC"	40
