string[domain]	list(string)[dictionary]	bool
"rawabawrawr"	["raw", "abr", "bara", "rawa", "wr"]	false
"zxzg"	["zg", "xz"]	false
"fffffffffffffffffffffffffffffffffffffffffffffffffffffffffffffffffffffffffffffffffffffffffffffffffffffffffffffffffffffffffffffffffffffffffffffffffffffft"	["f", "ff", "tf"]	false
"aaaaaaaaaaaaaaaaaaaaaaaaaaaaaaaaaaaaaaaaaaaaaaaaaaaaaaaaaaaaaaaaaaaaaaaaaaaaaaaaaaaaaaaaaaaaaaaaaaaaaaaaaaaaaaaaaaaaaaaaaaaaaaaaaaaaaaaaaaaaaaaaaaaaaamam"	["ma", "a", "aa"]	false
"ja"	["a", "j"]	true
"aqappzpfwbgaqappzpfwbgbfxtgaqqxcumzcgqw"	["wmxyxabt", "gfbbau", "wwyw", "fxuwyagmbpxuyaaz", "anpqyx", "wcqycz", "pbntagtu", "tfmtappgqnxbmcuz", "cczzbgwcbxwmp", "bab", "fczzzqfyugcmb", "wypzuca", "gtn", "ftmgzzm", "mqfybazupxqp", "fcub", "uxncaptwpqfcf", "gfabbnmmtzgbqucq", "tpxpcbg", "apzcqwuybyy", "uwgm", "ncpqqcb", "wwxmzmppytwtc", "ypapftbzxbyxz", "bwaumpxzczqb", "nxqnfbxzfwtgbtaua", "mbytnnuz", "wwtby", "tyqtu", "znpuu", "xncmpntu", "ytxzfynanwbp", "gnnfmunpamxzfm", "ftuaptffz", "anxnwtnwauqnmwazq", "yufwbp", "wuwuqgmuawfny", "zututx", "muffppu", "gqzxtyxuf", "ftmznmywpwwcnpft", "tfbmpbnyfnpng", "wxazagtmunuqxyzp", "anbn", "uttxfmnun", "qgyxwfqygafx", "qcgnqy", "upwccaawfpcb", "cpqmcnmtaagmmxccp", "xamynmmb", "mqcqpnqbgfzx", "wcymbpwtc", "atcqunfqxupg", "zmcbuanuamttg", "umacqny", "pbnntqnmpxau", "nypyzwq", "zpwfy", "buutyzgctyqfxa", "zftyumtxg", "czqzbaffwcwq", "pmxpmzzunqcnf", "cgfqucgffxnbfb", "nuzqxqpww", "bamqmpwtxb", "tqfyzxyqwcammpnm", "wczbanwuxncfzzw", "tpz", "cgqw", "wbx", "fnyyyynzzx", "zbnyqxcqgpgppn", "mypnqbaunfxm", "anqugxzgtgwgyzfaq", "pczw", "tztytb", "gqauzuwwnmbq", "wftcu", "ywwanbbqgxmxcb", "yfmqyncucxtapqcmf", "gybgabawfmpgza", "bnfnqyfxpmcq", "ywq", "bcncz", "tbwgqb", "nnmtfxtp", "mzzcwpaxcpc", "tcfqbqtxwxupzxqxz", "aubzwxaqgfbac", "pffmbuyxxp", "ubbgtxmmcat", "cmpcutwqgutnx", "gbgfmbc", "bufcayztwn", "bfgw", "aggzutntazqbu", "zfuybwqxw", "zpb", "nbyfxayt", "untynf", "pnznwyaq", "zznwmfatac", "aznambcmctfmcqmn", "xcnynyazmbznxu", "qgagxcx", "awxwabmymuqpf", "uaygunfwb", "mmpfqqwfuunqx", "btcnb", "ncxmaqawxtgmynyw", "tqpb", "cangbzcctttt", "zcfmffyuqmqmgp", "acbmcyymuxpzcxpzc", "tafmzwbq", "axntqym", "zmwxgbpzuqu", "ubmgzwqgaztc", "xygmyumwxx", "qqacztzx", "nqmgpbcxn", "cbbmzfwtfyynpgnzc", "wnfyyfmgcgpn", "yqnytbnmpcqzygf", "acyczgtbpfnc", "tmqtwyttuquanubpt", "pygz", "ampat", "mqbfzqwx", "pffpn", "cgpqfmnptggyqf", "bgnuugpa", "tyncga", "aqqumznxatmcg", "mbctafwpgf", "nuxfxnggtgwqpxw", "ngbgtzcfaaxcamm", "pmc", "bxtbaq", "cumyyawbwf", "ymgwbw", "qtzfyntumqz", "qacngmbzanaxwqapc", "fgwxqfupq", "mugxyanpacbf", "ymqgagwtquzm", "mubfmyxqqyu", "tpqnpz", "cwfcuuxcmubt", "mcmnmmqaa", "zzpauwtwf", "mpq", "ftqxfnmzq", "faqxzmubyfq", "ffcu", "mfgn", "cgxwypn", "bgfzzpnugpuu", "wyuxqxbqtqptwpxx", "zxgzqpab", "mnzcubnwzaawptyu", "pyuctpuxcggnwpp", "twagyqxzxfgcxn", "zfqgfpanwmnuwxwz", "naynznfbpxft", "atzppm", "mpx", "wcfagw", "mbatwpgq", "gwf", "maztttgbxxtca", "nmuf", "xbxanfqy", "tnuzmuynytuy", "nqt", "xawzz", "nffgpnnfy", "fwwptfgutup", "gcfpxfmnyycfyuc", "zpccymqcayyuyc", "xatgmbmnb", "ptufpnbbqzu", "nbqzzybwqqmzpx", "fguxg", "mppypnbfwcqxg", "zgymgyzmmwztgmmgw", "cggmwqyx", "bmmmc", "zywwmgb", "ungmnfaqfftmany", "buapabmfqwwppgt", "yfmwpc", "wnaxfz", "gaygqctfcmcp", "bmnqtqmzcamxg", "wuqzmmmm", "fugwbufc", "gztuqgxgcugazpzm", "zatp", "xpayamzanz", "zwmqc", "ytapnguzqzumyu", "xanfpccbpxacttftc", "zwgua", "xzmgbwcq", "qmquanpuy", "afqmbpmgcw", "taxcnbpxqnwbcmq", "xbtyzp", "cuppayyfbanxuwmwb", "pcuq", "cnptzw", "qcbtnby", "qpxqanpg", "attbytabfupuqmwcn", "fgbpawxtx", "bgqmzgwqbbg", "mayfgczqmwt", "npwnyapbymwunft", "fmutccbpbpyugtma", "apuqwqafywq", "czqfcn", "ybunwpncxqznqtwn", "xyg", "fwcwgqxtzbmfywpxz", "cfmnnbapmgmqapbtx", "mtzgyanpqpmm", "cpfmmpx", "fmgqqwqbtybgw", "nzmgnczgy", "gczbymztnb", "fzzaxwnqxupgg", "pacwxfuwy", "mnqxxwbctgzaczmub", "mxpuac", "ytzmqty", "znf", "ztmbzgaznywffnzu", "bpx", "pnxwaf", "abqbtutybyzytg", "wtcy", "tbugqntnpugauazz", "nwfmau", "fppucunatqtucp", "ycbyatfnxnubgbtpf", "zytbbqmzuuuta", "fgxbcbtyan", "mcnwbffmn", "tbpxzpyzp", "gagttzttu", "ctzubfcqtqqxqy", "ptwpmxgmpf", "zgnqan", "ftqaznp", "agz", "qcttz", "nnabugtyncp", "fmbxnqa", "zymcaupfxtbaw", "xtzfxzpz", "qwfbw", "yza", "abbwtycfxfa", "fcmuxub", "pfatf", "xncyxaupncamt", "gbuynayfqbnmapyu", "mpwupafzfzxmt", "ngq", "mabmc", "pmfppau", "qfwxtabbcbbmxy", "gzw", "zfppqgmfpxwugpu", "ymyu", "mnwzw", "zanummumyuu", "qptmqanwpwcupbup", "qwunq", "pbzntacc", "qgqaanpzgazumm", "wxtyabmq", "bfmwupyymfa", "ctutmxa", "cngammftfuwzap", "ffzbqztgnnyt", "zwxz", "gpwbt", "xynu", "xgycc", "ymnzmgxfxgc", "qyxtbxfgttcaz", "wfcqzcyqppyaxxy", "bxc", "gwgqp", "mwbzzagnpapaqbg", "qbmxcpyytunqcz", "tcxzb", "qqbtmupxqupmx", "uazxwwutypqmtnxb", "fabyqgpzauna", "ftmppppntfpc", "uwugxmucqz", "nnu", "cyafnfwqbfqmnfzwx", "guat", "bayuqpnbggxazfw", "nzqftzygyataufwya", "catpbuya", "ggpzgwmzxwm", "ttwmbztmcyywtzcb", "abmxpxzqwtpbntm", "qxpfgzg", "fwacummxpptfznq", "wpfapmybxgg", "zyguzbxzfbx", "tzgwxbfuwbupfn", "zytfpwauybzggfwy", "pzmgmtubtmbt", "xbwaxybxzpnqxzna", "cbqg", "cqtycgpbfybmnf", "uzxa", "xqcuqzmyzncqbbnp", "wytmqtw", "caqmpppntbgmgpcpm", "nut", "pztzcxuamtuuab", "zpgubmttn", "wgzb", "gyffpnwunfggfxqt", "mxtzpgffabcy", "canaf", "mzqzbzpumx", "bbgnfpnqxg", "fxuzby", "qwgfutqqnwufzgqgb", "tamzfwc", "uwqnytntnbat", "qyyuf", "nyczqypq", "fbuxyxpmbzapubgwb", "wftxuzfwufb", "ccxtwaznzufaxq", "fagmczqfnptzxz", "tfmyqtg", "ynnt", "tyb", "wmxbybpfu", "mutx", "baxnntzwyugaubgzf", "tpnpbfacyptgaag", "mtpnxcgnnnnucqq", "wqacfcuqwaxtx", "ymyxaaazczgzfz", "ayncuyccpwqugy", "pnm", "pnwmppxmugc", "mnbfyxqcpnzxbcq", "acnqppyzgnfmyc", "cyyctqgtgu", "buznxcnq", "tctc", "cpwxtancnbbxgpgzz", "atffmw", "nquxxwpfaxuxgnpqx", "ctyq", "pafmbnmgatn", "ugpanytcppmapuuw", "atbwumbwuqntpt", "ynaaucta", "xcapfagcbwxc", "maxqwpuxgpfmfzb", "qpbngpmtay", "pctnupncw", "ypytgugmmzmz", "fwbmqzxun", "ptntwyn", "fufmp", "naamgntaxq", "xmtufxpc", "pwyuyzxx", "nqnau", "cmnfupmtgtumnaafm", "bgqgupytftfqzunut", "fuqbwzzynggyn", "xbapnmmfqxbpybc", "tgt", "ybfcaznzfnw", "zgx", "fmxwxtgncqymqx", "ytct", "cbaffncyfy", "qwtt", "xmafxufwat", "bmmgmzfx", "xxtmqcxcqwmapapc", "twxnmfyqtq", "payuzqfaawwqwbwa", "zpybfptbcuaxt", "ybuxgfbzap", "xtnm", "fguucax", "mcpmqbmp", "yfzcbqgmc", "wtqgyqqqbycmw", "gqc", "mnfpzwzt", "aaqanwggftgufpqx", "yayquauacm", "gzpgpfnfaw", "tfu", "cgcwcam", "uqb", "bfyfpptxuumqnuu", "npaxz", "ytfcwzpctaf", "pmuf", "uywpynnmtmzb", "fazmyunnatmx", "fqgaagqagxyu", "xqxngu", "wauabcbcam", "nmptuq", "cwt", "gwtzgqyzbtpbyu", "cumqgmuqcpbpx", "buumbpczmggqmaybm", "bwzbgtfxygqctcnmx", "yxtgbzpttzbmyy", "pbafyf", "wunqpygapwu", "wpbcaznnf", "yxqubtxn", "yybwunaapxxafbfgp", "gbcwxbcx", "tgzfytpnznag", "fwmmftbuauattgc", "ywbcqzpmb", "gfpngmczyyzzbwtgw", "gccfgggafc", "ayc", "pxgaqgtwfzbbumxm", "maumumcqmgzwbmmy", "mgmuzq", "uuzay", "tqwbxm", "xpq", "ctgmqanq", "xbgzfgpnw", "gnp", "yxnm", "qawynmp", "pmzn", "xqxmqpwc", "bqfzgxfammxu", "xtfqtqpxcunyfuuc", "gyxqcmquwzmygqpq", "cmfzwpwwtcpfzzc", "qyuacpyupwbmpmqg", "fumqwa", "zzccucbabfbagby", "gwtbqmwxttuuz", "ccgqmywqy", "uqgym", "tgcutgzzbwzcamb", "bnxw", "gfqnmt", "pgauw", "mxxgygntfbxyq", "wpqwqtwpxgyqnbmf", "munq", "gzpggnygbyacf", "gttmpffgbxt", "znxwxymyfnf", "cnpxfcznqyx", "fnftymaqaba", "xggbnzpbnpwpbzb", "nnqwmmmtuzxzugqm", "zwuwzzqgnmqqfwmg", "uptbgywqb", "tftftfbwxxfg", "wxtxcmmcfgf", "qycuqxxmcmztnptf", "xmcga", "atgxcucgqacuabn", "mcfmtafuwpytt", "cyupqbympxatycfzp", "uxbpztupqqzamzx", "gacaxw", "qnycwacaxm", "ampnnyzqmg", "bqczbm", "acyqfazcbqmfpcn", "bpaxt", "utwyqqax", "wzqagpuuzqqqcpx", "pncpamgtyzxttwwfz", "nyfgpfg", "ycywmufpazmab", "bgzgfqxgcu", "ucwymw", "apbf", "fzc", "qbafcx", "ftpxwbtaygcgbzqy", "mwqmymybpmqabm", "uqtxwumwxyzwp", "fmtfcp", "zxqwfcmbbu", "buxz", "qamnuqzygwqfuc", "wzutbafa", "cxzccfc", "fbqubmpzczbmwybny", "apmpcytpgqccynfb", "wyptuzxwzaga", "puuygnunwqfmnmngq", "xwgagtnupppb", "ynbmyfqxmcyyzpm", "znwqfxnwb", "gfcwymtxaypwtpgy", "auc", "npbgbcxzcwzfupcac", "tmqbgc", "cybzfcx", "fmfwww", "gcxuqxmxqxtgt", "xyz", "fywwnnb", "wxcuawcfqn", "wgfqbzpzaagucaax", "nywcayxww", "unwmbqywypwgwtbp", "gcxywybwymu", "xngzqpbxw", "xnuquynntnwxx", "aqappzpfwbg", "amuyw", "ctznng", "mxqmyfayyzpmn", "ygwbutnaa", "ufwwc", "qcqxx", "xwpbcfuncn", "qzyxzzungcypfbcnx", "qgzu", "pabcmtcyun", "xggawmtp", "qfcpwpnnatau", "aagauqqqz", "qzfq", "fmgycfbwgmpttcqwn", "cftfupnuqmytma", "ctqxuzmt", "zaqab", "tgwtxmwxpw", "taagwgn", "pfnnntftubyyfabn", "ygqwfxaawgqwyywfy", "pafapp", "fyqnxmpzxapzwwqgt", "yxzygwn", "tqxmbqqag", "ypctaay", "yqgyaxmbmzbpgb", "ypnqtbyunx", "zqzzfb", "ybyy", "ggmyczaumzuzwwcp", "bbpymw", "bfxtgaqqxcumz", "znyyxzwzbfttuzpc", "bum", "ncctqwqfxtwqa", "wnxbxgbzmcp", "pfbumfxufptqban", "bzn", "zctzbwncqnwy", "bzmwtgqfxxyx", "bycgbn", "tgma", "mwauyn", "wuppyaanbtmucngmb", "pmcmzybnwxcqpfmt", "abq", "gcxxyybnqwxwf", "wqcuwfzgzpubccg", "yzzp", "qbzp", "cttxnwbqwxcyuw", "nyb", "tfmwbz", "nzqqymqc", "myzcqbgqbamxffgxn", "ttngpgggaqwg", "wpw", "fpwq", "pff", "nmzgmggmcfuq", "mznfwau", "apzub", "qybgzgaqz", "tfbccanyxyuqpbmtn", "namzabzzzzx", "xafp", "bbzuzbpxcnq", "qtxqupaqmmpqzz", "cgubwyxyawqt", "cqnpymcwqqmx", "qwapnbanaagwfb", "mnxyfmqmxnugnbc", "qyzqtxwbmp", "cpgtbmtfz", "fpwgpfxcqgaw", "wzmaxuwmw", "qpwypy", "fcbgfwqfcwnfpt", "gcwzfmycyz", "yyunbaayu", "npt", "mgwxuxmqm", "fqpufx", "bbay", "ytcqanatcffqpq", "uyuuu", "zwgwa", "zxzcuaycwnabg", "zpufxqttp", "zuuf", "gxzctfpupt", "ugqfqaxmnqtfwwcbc", "wqumnmgt", "wzwabacytyqfwngz", "uzu", "wtuzaaqw", "qanzppmqwpb", "tfqcqpzubgcn", "apbxyznp", "mmcmffguxy", "zzyf", "gnffpgznambwn", "gtbuqxmgpccfxuz", "azqnwmm", "nmbwmf", "fcgtuqpnfu", "tgfatmxycn", "nczt", "cngguxqw"]	true
"lxqe"	["e", "lxq", "qe"]	true
"e"	["e"]	true
"sscc"	["cs", "sc"]	false
"xecohichiognohugpunxuenzihwdpnaerzgnccerxgznnpnggczduhnudixhxroupizha"	["zehi", "xunczwwoihxidaucnagccnr", "cdrocow", "zdrraxgnzgdeihrni", "roacpdxxgruggwwi", "punxu", "xoruxgzniroxwrpoozw", "pcdieniiwougpohgghg", "pznnx", "dpprpao", "gap", "xxacnxuguppgzpoiczrd", "zwrdzhxozggaeppdopuiur", "g", "cgcipnud", "xecohichiogno", "pdxixprxezcordu", "rwweheoowazxic", "cggzwiprohowi", "ocezzc", "iwuxagzarzedgxzho", "uhxcizw", "ewopgxxxhahdnr", "gurdrwcr", "oahhpden", "odxpogpgehcpiccgxucwzn", "cewrgpggh", "auzcxrxpnuxaw", "enzihwdpn", "ouengxunprwoanaaaad", "xxcuxaxneu", "aupeghpdipdrc", "reaerhdrordaohxgcne", "wounwicuazgzew", "gagnw", "chdgwdxpncuniui", "uhgzggczoxiaedrgndedgew", "ihenzx", "nzdwraadnadz", "rruecdxiwxhan", "zeg", "hzrgipxgrhocdixnizucup", "dxuwadi", "xxppdzowxhopwach", "hecpzenhxzzdaouhnnuh", "haxuruhzdxhoegpcexn", "aernonxgxeihawrnnigoaepow", "xwodnpwcpewxaur", "neroxwixhrco", "icxnngningowcczaad", "xixxhezcaizixwrxrpheccphw", "xhnguoozcxidddxxeo", "nnoin", "droxnduuhw", "izcrzcupga", "rucnuacgzdwgwx", "wueahhdgdiuzz", "dowpeezpapigieugi", "dzizgurenwrdneagxuchdh", "ignpdoxwougid", "oxunarpwze", "rizcaozophuexzpni", "xihwe", "enwgzriihhpduzgoeppd", "upeoipxapcohpie", "cxir", "pnwiegniwoggzpe", "iawg", "ggwuucgdpicahhzrgwo", "ahaoxoxui", "grxiiduzapcpcccauhopug", "ppcccw", "dghxwngwhp", "nwgpagzuwriwndog", "xgwprcpaohrnr", "daoi", "xrzuxni", "upwrgnooewnxiaieaauhdx", "aoiocupicoc", "zzpzdhc", "z", "x", "awzuh", "ir", "rhddhpacewprcnhuipzpnaa", "zawxhn", "axdeerhr", "niurpzgecnc", "rrdaexnaidzg", "hhe", "hzchero", "iodhruawgaezdzgchxe", "drd", "dgdehwawgruxdhxhenr", "wrurhercechgnznzupacw", "ddnxwwh", "zwrznzgpupaixzpd", "rzcuodzduiwwewrocapwx", "regpgpnaogud", "a", "woahcdirahixaecw", "cpgo", "zigriuhediiwuho", "rndgaacrzwwnn", "ardiigugrrp", "enndwxicrdadhaochdcacoo", "dcdxwdrnpzr", "oiizzihpeuwohigoo", "zuieniaepp", "dddpo", "uahapcxazhucradaeico", "aoarhpzwooxpaicorwhggd", "ncc", "ahzunuorcipxrpecngwaerd", "nrhgadwrzexxnhrrgocaz", "carhee", "roupizha", "nrurxa", "xnzzpruuzxwghauae", "oznanwoi", "puouurwzoazxpwoeg", "ozirazgiouwuphnwnocpueodg", "pozwihdxa", "xhhuewaccuzpuc", "ae", "n", "hexwzowripzp", "orupgxheizr", "urrdwrg", "goiuegurrarrizoxgaucoco", "igapgdxddazgan", "aerzgnccerxgznnpngudixhx", "engwxzaiwocrangneigwodug", "nuwppipncpwpdcgipcwi", "apduzdxo", "undrzducizwdcirgxe", "rwp", "p", "px", "gczduhn", "hu", "ozaaigiwahhuhorc", "dxuhnnhdudzdonw", "egnunxegpeazan", "aiaarcarn", "xznpxuieeawpoizonponuxrwa", "aocoarwuonup", "pagaeaxprxihdriwod", "wuzwxihzgudneoxuggewpwg", "xohnpw"]	false
"xbusmed"	["busm", "xbusm", "usme", "ed", "x"]	true
"etiptnddjk"	["eti", "ptnd", "tnd", "djk", "etip"]	true
"leezewkkeqyweelxqjcbwrsjlbekkjlryelksrbzszrrjrklwusxlwcbsxsxjlsrxuuwyvjqjvllvszrlvykqvkzryykqxcjrlu"	["wzxeejzbuk", "wc", "esxckess", "csslxyqxqjvbqju", "uz", "seksuwcqeuqjeu", "elrblqz", "ewrsevqbbskyx", "lr", "zz", "kk", "qkzqlbxrlblxw", "qvkzryykqxc", "k", "yqqlexxrxzv", "usxlwcbsxsxjl", "lbekk", "wwxckyzxlkcbk", "bcwskjvlxzs", "zwvjzzy", "bjjqeu", "xjjkrxkzrkkquwx", "ujj", "cc", "wqrkqbzulsbybys", "qrclujuqrvz", "qylqsqkyjlbc", "yljyzwy", "xyvscqyqz", "leezewkkeqyweel", "exvwjqycur", "kyxvee", "rbzszrrjrklw", "uerl", "jlryelks", "zbbqwyljebzu", "jvllvszrlvyk", "jrlu", "srxuuwyvj", "q", "w", "uyk", "ejbrxqkuyrlcr", "zvwu", "rrzbckle", "ylxjvlucclwy", "zrulewbzjvqclcx", "xqjcbwrsj", "swelbjyjw", "qyzlsyljjq"]	true
"hhwhhh"	["hh", "wh"]	true
"fddbhdth"	["dth", "fdd", "bh", "fddbh"]	true
"ssssssss"	["ssss", "ss", "sss"]	true
"bbbbbbbbbbbbbbbbbbbbbbbbbbbbbbbbbbbbbbbbbbbbbbbbbbbbbbbbbbbbbbbbbbbbbbbbbbbtbbbbbbbbbbbbbbbbbbbbbbbbbbbbbbbbbbbbbbbbbbbbbbbbbbbbbbbbbbbbbbbbbbbbbbbbbbb"	["bbbbbb", "bbbbbbb", "bbb", "b", "bbbbbbbbb", "bb", "bbbbb", "bbbbbbbb", "bbbb", "bbbbbbbbbb"]	false
"zvnb"	["zvn", "z", "nb", "v"]	true
"xx"	["xxxx", "i", "xxx", "x"]	true
"nqqgnzqgngzqggznnzzzzgznznzgzg"	["qgqgz", "nznn", "gnqz", "gzg", "zz", "nn", "qn", "ggngg", "nz", "z", "znzn", "gzq", "qzgzz", "znzqg", "gnqn", "qnqz", "zgn", "ggnq", "qnq", "ggqz", "qgn", "ng", "gg", "g", "qzgz", "gnzq", "ngn", "qnz", "zn", "nqg", "nzg", "nng", "gnq", "gznn", "qzqqq", "ggg", "nnqq", "zzgz", "zq", "zqg", "nnn", "nqgz", "nqq", "gngz", "qgqng", "qq", "n", "qgq", "zzgn", "qg"]	true
"qssdasja"	["qssda", "saqu", "saqgr"]	false
"h"	["r"]	false
"alllrllr"	["rl", "al", "la", "ll"]	false
"ppppppp"	["pppp", "pp"]	false
"igxd"	["ig", "igx", "xd"]	true
"zhxpstngwxp"	["stngwxp", "zhxps", "zhxp", "zh"]	true
"oooooooooooooooooooooooooooooooooooooooooooooooooooooooooooooooooooooooooooooooooooooooooooooooooooooooooooooooooooooooooooooooooooooooooooooooooooooow"	["oooooooo", "oooo", "o", "ooo", "ooooo", "oo", "ooooooo", "oooooo", "oooooooooo", "ooooooooo"]	false
"ignpdwqlgqieogvplynjynjeeiug"	["rj", "leolnrjr", "nijo", "ul", "uoljvqoyep", "gvu", "qjujndqvvpqv", "dr", "ivw", "ow", "dungriwuywoquw", "idddnjrv", "nueurre", "wnyg", "eogqupniyperdyg", "lowi", "gqvnerjr", "qiwelrpijjnol", "nqyvj", "yuurvioyldpqed", "j", "ugwd", "rlgevrvw", "djydepvw", "idqpjyqwoguu", "dnppdewdug", "rynipvnodviy", "jqqnwprqvdndl", "ieuvvpyv", "pnjilpij", "uniddouvqqnnen", "nv", "eqpep", "vveeporlprngul", "iejyoun", "ooeqrvoe", "ngwpeneo", "y", "pjrjoiwoodrdn", "jljlveruid", "djvovjlg", "vle", "qeluilrevdlllve", "iwl", "ypnqep", "gpuloyeeulngp", "grgdndiujpq", "iwlqpogywvw", "jvniidr", "eogvpl", "rdnrwepoele", "wgr", "eewqoqqwr", "dorlped", "lewdioqvrppde", "nwyuqgyvvo", "dgnnqjyvgiuurgp", "deur", "ergu", "odiuuo", "jw", "l", "djijdyrulye", "uu", "pqplqpnrgd", "qdippwuurlydgvn", "lordewqjduvpgli", "ge", "qipvpoddy", "gllqjvvwuvn", "ideuyjweyjwgqwg", "ojlgqdeyn", "qilrwlnyilewody", "vwyqw", "ungeple", "dwgvjoywjgoqnpo", "rljrnpep", "pjurjdqp", "gip", "uvjlidlvopvuoi", "wyldrioyund", "evnorndw", "qiqdlgyeeejgvo", "iivd", "qdu", "uwirdor", "ylie", "pijpgqdloijwnyv", "o", "nvgrdduodovr", "ollgdvyllo", "ovuljqoevwyd", "vpigniuqwu", "ppenglyloppdn", "eq", "pndevdiqivgdygo", "ogginleldyii", "edyguodeduliwwd", "ni", "veqjnloidw", "gpidgwjoenqyrwo", "wyourwyojngdju", "vlg", "gnyyjnwvndr", "pd", "ydlw", "gdjionr", "gpypqvyl", "gwroydwu", "gouipp", "qjqlrori", "njudrqdiupjuqe", "qqovjeroodp", "gyluiwnedji", "eriyyrivvp", "dwgdjunq", "gpolunurrlguuyw", "ypui", "jidp", "vevppvqjynvww", "ovwnqvouelprwli", "qoongdnljiupwy", "vldydriilprldpg", "deov", "inwnnyyqjidyuwo", "gqdwrnpnvyi", "lvlry", "qnddoypy", "prpj", "qeuuu", "pjilgvquwrwnd", "qdwiuyudej", "erpjuevlvwei", "vpviyuoqyd", "oqvp", "gojndoupdeod", "louevyqqdr", "idgyu", "pwinjnquoop", "vveej", "jwd", "gvdwnoqejr", "peequijpe", "iupvorw", "do", "uwiorigw", "gjgnowqwelpir", "yioeroru", "yydrwlnijn", "dgllrelyogqqp", "ililridwq", "vlwlpirneup", "ieu", "elvd", "qgdngqwlproy", "dlyln", "ny", "wwooyqlogpep", "yrjerlwdy", "enyr", "dp", "r", "epjydglww", "qyvlrwoqwr", "qgw", "upngqunydeo", "joupvivoi", "qvuq", "ueejyqdridldlny", "ywweiyivvergg", "glri", "u", "luvlgvlpdu", "ygrnliiynuu", "pelnqenppqrppu", "vuelq", "wvnyvodonydviv", "errioguyww", "pduqlryndyeu", "lidqperypjqv", "leijudqgeido", "lgpdeld", "diieuouvuyrqyo", "peq", "iliovugyiooryi", "nenqeivgvnnyj", "yve", "vringqopogidliw", "dodgyewnjl", "g", "uvyd", "eerionvugopde", "yoiypqqjv", "gidnqwpeliiddd", "egvruwrjljeje", "onwwlw", "vepqwiqvwd", "eoni", "d", "gyjuwlyjdvg", "uuyyg", "wilgroiwiio", "wdnlwlpyegp", "jyoov", "nqyiqoglw", "dlvwujvldnv", "puwioywelpqql", "jpvqgjnlpge", "uqd", "jpuypunveegp", "onle", "yuwdqeoqniwg", "nuqpowpgwirwu", "nvollevv", "eovnwlgguwlrg", "giuuuu", "rprnlndeejlw", "vgd", "wlovgpgoup", "lonlwedowdudy", "jweupeqvj", "gvijjwinlurey", "jv", "div", "gqenjj", "wl", "ninru", "quwjjdjlg", "oo", "qwiodjwlygevn", "ogruqylrgpy", "wdywqgvur", "ooowjnryee", "ruyeune", "wv", "rpv", "ynild", "yjgeug", "vlivjygyeq", "urpngqqwqnrwwdo", "rrgvyelyn", "uqi", "gpqwgnwvijlol", "eodoygiwqj", "ig", "pvpiovgr", "jnqvrygqqu", "qrovjjeoww", "yrvueujpeueuu", "jnpy", "gqgppvnqjypv", "uripjpiiigyulq", "nugrlwqll", "jwqryrywvjd", "peivlwye", "gvindrdd", "uwy", "ueqjnquulloyi", "qowwqgeerwio", "ejlooj", "wjundlp", "ddgryre", "gliyqeygw", "gngg", "ulonqigqwnnoj", "yjrverwd", "rjwyyqwjeqdnui", "lqogweiune", "jdgpqriuydgj", "jgnqjpownqi", "egvvjvrinlr", "iyewne", "ywpgevvj", "nq", "ledyleivged", "yjo", "winodv", "oiwulqdyipngvol", "eiuowpjgjwwu", "niu", "plppeqgyji", "duuworyy", "nlo", "wjd", "wlwivwjwpleo", "nngrlwrwuigp", "rjwrnyy", "wgoyldopg", "ejldwnwqyi", "yp", "ploy", "yjpnjelnu", "iiewprqv", "nvepoyvngjyw", "vrlyjpe", "vewrvprn", "vduq", "nrunnieq", "egwqv", "yeveqg", "vppnppynwe", "pvj", "qlpiiqpoddjjg", "ngvwqjllwqglv", "nuvgr", "onejrgrgdy", "jvdlgr", "ynqqnqqoy", "juirlywvrl", "prnrgiynnioyd", "yuynglggjldjrr", "pvi", "ri", "gurujwgupl", "gpqdywjyun", "owornioleqlp", "nlovqe", "wlpnlpeqglpjdig", "iyelqqdojnrp", "gugqoqgy", "wpjp", "pulurwiun", "vjyvyu", "dpnoig", "wgqprndnevyvn", "nvqndjurwrul", "oynujggigjo", "gegqrwidjuqruro", "vivygnqyq", "pqgvjnirprry", "wnq", "lyuvyoqpqqenlvy", "rnqwuygggpy", "rllwwnojnqiyyw", "enwn", "nrwiegyqqi", "dlpngiigvnoo", "nienyvywoin", "upgn", "uejoilwgvrgvl", "nidwjwjnrjuoipi", "yjwquu", "duj", "qeuwqyiiijew", "vjjwvvd", "ydoeindnii", "jdqrlo", "nqpydwgudggnye", "opip", "iyu", "wvjlldevepqroe", "rde", "nidnnlywidq", "wron", "pw", "nulordjljyje", "vwnqpew", "njrviyuinwyqulr", "yyeweqeqelgwrg", "pu", "jryw", "qidny", "wyqvrpregrw", "rgilypyuid", "wdurrduielnoier", "jpyn", "vgg", "ddwn", "ugudnpurlvop", "dpqo", "vyludvejlrjrior", "nrolg", "voiqevwyyqip", "dreyugnvyuvjrp", "girpgjprpgwy", "qvjnjwvlydyv", "uinrjoyyp", "nev", "dgjl", "eviileuyoiigp", "ojyiedldeui", "ejrwdpirgvdvepr", "wugjewj", "eopidjqwddjjigw", "ldujigjrwlq", "vedulnylulnryr", "ovllqryon", "wuidq", "orqlyd", "egpnyywuylnuy", "yepelngiiwro", "ydpjlv", "ouoopgrldo", "i", "vwpogyyjuouwrrn", "ieqevy", "iuqowiu", "uriorgqyg", "eppwwpqgwoqonw", "geurojlierdqud", "ijlw", "uipyoreooovp", "w", "ijwundugvjoy", "voqrepnorjyo", "lw", "wiiqgypgulrw", "luuwijgl", "dgdyqjlgwqo", "rqrnylnjprw", "liuiq", "uq", "weljud", "uv", "dyjwvjyenldq", "qrrplrqygvewup", "veqwgrpoyj", "rivevgpunql", "uqienpn", "pwiqlqg", "dewiwi", "pdjuwpvo", "nnupqpyd", "pdyrjj", "rllgvoivnqgro", "npdwqlgqi", "nelqj", "gvdovwerqrwue", "rjuvy", "uwwnworovuvq", "lnnvqjjdlvoj", "uwvpwneuiidgnw", "ejyio", "jywewudnpwjqp", "eynojqyugdv", "pwdidv", "ovu", "wipillgp", "jlgvywooul", "ernyjojlo", "jedy", "q", "rqngyw", "dvwodoievp", "owjqqnrlwd", "ongjn", "uwyeipvwr", "yn", "gidpdui", "neerpeug", "yund", "jn", "euryrgidg", "ewlj", "el", "ylejo", "ledqlu", "yuworuoippdyjl", "pgugwn", "yjleejjieud", "gjuqy", "rvpy", "rgjvwp", "leyeerleedji", "oooiogwvyyqdgjl", "dprrjpdley", "olen", "poueqjupyupp", "drujrorlwq", "ynjynjeeiug", "uy", "jqiiqlj", "nwdpupu", "lpu", "wweuugiwplv", "uuuwrevpnyudoqq", "p", "gynguorppepg", "dqryqiyunvvu", "oerwgu", "nljgv", "evjpu", "lvvowrnl", "uylwoiuqupld", "v", "einjuyujqe", "ejilejrgv", "wrrqevvqoyen", "gveupqjgjrdyg", "dgppllog", "onjq", "jorql", "iwwijoje", "owppjojliyylnu", "ldep", "gqeprelrywgr", "qdugwqrnr", "goeprjnypppreup", "jeoyywui", "wjgwi", "npoeveiydryq", "qnjw", "jpyrlrryl", "ugg", "ejpoejgdvuedgeo", "vonviopruneueqd", "lovinwdjud", "ruyryuy", "ouldg", "gqpelwwvwluqiu", "nnlvnunupr", "jrirjov", "wownddnigiv", "owvqjdo", "qr", "ynvuqvvoy", "ygiuluerylqj", "ieuweioidy", "lnwjjdgppldl", "vr", "nrpqyrelrjie", "qqp", "ijdpdivdvu", "evnewwiwellg", "envypneqlqwy", "oiirewjdgiyy", "rlryoyrvoeu", "eyenjq", "qwevroegqqgg", "igdnroy", "qqviw", "ndeprig", "rqgvoqpny", "wvlwjguowewdqqi", "gyeqony", "iqdjgwwewqnpqjl", "juogirnw", "nve", "env", "qlejrgui", "qewyivvoldduolq", "dv", "wdjywnnp", "viejprw", "jjueujulwu", "nqpyjv", "ler", "pqqu", "eoir", "doogdqrnulpvwev", "eupdooj", "wuvrerp", "oiyuyoylrpplryq", "jdqqdjnduedype", "or", "lrewp", "nw", "vjiy", "nuwpjjggypueor", "uqdqwuw", "wnpg", "wlnegwodueww", "ulgwyquj", "ndqeqjleyynnww", "jplwiwpo", "ppnnon", "dyvvyuewlig", "lnrdyweuyjond", "ieqjy", "onnle", "lrqoplwew", "yvi", "ugqlogyl", "pl", "qqlylr", "ewgo", "ggw", "grriegqggynp", "viruqull", "wyjguvnldo", "jyelu", "veywo", "rigwvwqevenoep", "e", "wyyedyy", "jvpypqdrqnge", "yoqiupe", "vojlvjg", "qeoeuiirvedqe", "riol", "gjnipqinvu", "vwoowggqvw", "nnre", "yq", "gupyoeoiednnn", "wpdqonpyu", "gwier", "rougvgwnyi", "vdudplonii", "ojrwjwywrvgp", "vwqedvjj", "iewjglrvqg", "iogwpg", "qepnorjvpjny", "dyir", "pwuuj", "yjvnojdqnyqdqe", "gludyeqjyujuqui", "ddpqieo", "linnuqpulilwyd", "gqegpvriy", "edgjrupwvnyn", "jll", "vijoyv", "nlguddgpliguiew", "joduoowenwq", "ywionreeei", "uwvpvvpr", "glrgpq", "npqryjwiveggwuu", "pqrpewgujg", "dvnqqirrn", "qeygnnjderryir", "pyoipgrqqd", "qi", "wd", "qqnipjou", "nwqnvdwuqepe", "wwolilju", "ngr", "orirrygevddw", "ulirvrl", "yqiwlqvjjduvgu", "rpivdgj", "ddprn", "wpyw", "wegqrrvgouy", "vqdqedldg", "rld", "uej", "rjwd", "ppylpvve", "voie", "nnoqggpjwoowog", "jjelooqyvnijin", "udje", "oe", "grpgvuowljr", "pdvqppeuewip", "wn"]	true
"rcsczpilzzlksszzzzlbbbzblkksklzqklbpsbqkqizsckbikqsbiklpk"	["zlbkisrlqsrizqpiqzk", "ilkssklqkrsk", "bkzkbkic", "czbblipprkpclc", "kikrqqrlzpil", "bcpklr", "rlpppcqks", "crrrsl", "ziclk", "zlczpqlpbzirrpq", "isqlcbbzcbqbllrk", "psiipzlpqbbspbqlz", "ircrppzzcpkskcirpcz", "lqlpkzqp", "zzpkciqsk", "sckkccrrcp", "lissibqcbqskqsi", "zrszklzkipqs", "skrprsrkkliizzbpqqi", "ksqsz", "iklpk", "lsrklcibp", "prlsszbzi", "zplpbszbzcqri", "zqlzkplqqskqrzzzl", "qizcqcbkiqslircb", "bblcklsclkic", "cplskzcccprqlbqbs", "plqsbliklcbprcicq", "qkbzriqzsrzkrzcpppc", "zkbqlzlqs", "pbccszrzscqzb", "kslzcpbprl", "bprrck", "zpblcqrrszclcbzpcqz", "lklzssbip", "pqppqllcksprlllli", "skbspziblp", "kbllb", "sqlllzr", "rlpqkrcilrllpzscqbb", "kzsqsbqlbkbskzr", "zbqbqqspslsqckbzcz", "iizkisbpzrckppqkz", "lpzcbp", "qslkppllzklri", "pisqcqbqrpczb", "bpzciqizkrc", "bsiliczk", "lispcbis", "kiqkicrcsspiqlqq", "qcplrikrb", "clqlr", "rkpisrrlikl", "lbclqiq", "irlqqzkzbkqpkbk", "rbrkkci", "qqrrszpqqbcrkslz", "rccklppcrqz", "scscilcbirlrl", "pbrsiksilkqrbk", "icpillrbc", "sprzzlqcbi", "ckqipi", "cpcrpirliib", "llcblzcl", "bbbqrkbzibqlckc", "rqiirklqkrrqpkpbs", "qbpisprcppi", "bzzkrbpqc", "kskskqpslbipks", "qszrcclczcbisqpll", "sppqbb", "ppizqczkirrrlr", "lqbillcpibbssrc", "qrssksk", "zkcpcpil", "pcprirpqrbci", "ibrkqlzqbkr", "qpcsp", "icbszqipibb", "krbzkqbksls", "kiirpccibpbckkksk", "ccsbzbkzi", "rlrzkpzirsqqrrpic", "pbscplciippqbzilpc", "bkllick", "rlbqcqsprqs", "kzikbs", "qqizrplqqzi", "ipqlprrql", "lrklrlqllilcpkp", "pirilrcpskizbizqb", "kkciklkrcrr", "srbikpbkpcklrqicb", "qkqbirpiprz", "zrrrbckbczczlks", "lcplilskbqzczbzsql", "zrzsp", "rpzzlcrql", "kliszps", "rqikrbipqqqkslprbz", "bpircpzizsp", "sczsrkssic", "zpsks", "kllqzcilpqbccsrrbb", "bkizkl", "pscccrbbprrq", "spbpczszkbbqbpibpbq", "zriccspk", "plpkqbqppirccklqk", "rkqcpzckpirlkbrzbrc", "qplbkclrslqr", "qipsqzppb", "cpskq", "bkiqizclq", "rqiriskb", "ibbqqkzslipbpkrkkb", "cckikccis", "rzkbkblsbblcqkbp", "spkliikczc", "iqikrsprpsqizplr", "cicrbbpikprlprkbrz", "ilzkbzbkiqb", "zbprk", "qzpip", "pbrlskiprrzi", "pcqrlrqbk", "srrkzr", "blilrprslzzblsps", "zqklbps", "qpqscrlzbklssksbcq", "ibcplsqrbzqk", "lcbbskssprqbqcb", "rrplkszpiqczlib", "kcrsqp", "lckcsrcqz", "krqqsrqci", "spbsczsqrl", "qclpzizcrklklbkrl", "qlcsccqbrbkpcpkcr", "rpqqlqbpqzbilskqk", "ckpikibpzqqkrlsiqc", "srzcblzbqqzppz", "kplpsbilzqkpizzqsls", "krrzbblbbz", "iccrikzlpbrqc", "skrskllcbpp", "cczcckqzklq", "bscsliibckpbkprzzq", "lbrzrzslqplq", "krcckp", "ppzrkipsrzrlilq", "zqprizlzsi", "icrqipsqslbspblzcks", "bkilkpriqkrilz", "lzsprk", "isqiqprsrrsq", "lkziiz", "bzpcszlrbbsclpz", "kbcbqk", "qizrbckrzzrkclq", "bkkppsqsrkribkbbb", "ilqkb", "lrzrksbcsqccbi", "pqsiicqbkizirsqblzp", "pkkpzq", "lqprzibkszcspskclqk", "kzkcqicrzzpzrsqqs", "csslrb", "ipblzpcpbrbb", "lpppzsb", "bzsibrcck", "cscbqlszizqliikzrzs", "bqbkiqlicpcrzpbssc", "pilzzl", "cszkqcb", "zczqlkkrqiiczqssbq", "crprrrrblkr", "crcibqcbip", "spliip", "zkrqcscqlislr", "slspcipcqzpzrkki", "pqibcbskssrk", "pqirczbpzqlk", "psrkz", "kkikrbilcbrirszqq", "bpzsqckrqkbb", "zqssqsziccir", "lqikzbqrlkcikskqz", "bsrklqlzsrpkzrqpkb", "kciibsqrbqbkslbbip", "ckkilbklkqisqlrizp", "klqrbc", "zpslbrpq", "ikkblsplrrbkbi", "iiiscprisrzcrcqil", "zpkbzlqiks", "lbczbkplllqlzzibi", "zcpkscbzilpslciqc", "pbzskplckk", "kzsqpisbrl", "zizliilbppbzrklckpz", "qssczqkclbillsr", "llqppqpqqrsbiskibc", "kzzbpcqzp", "czlibqz", "pplrqzzrqlizliplbpz", "lpkpblpsssi", "bikqsb", "qsprzprllzqi", "sbbkkkp", "cblbpik", "lirqz", "zlbqiibkbbrcripzspq", "isrlskkkczssccqrcz", "siqrkrlzzlkrkizb", "pksspbrqkppz", "szqpssklrliirp", "qrpprlzklbsk", "rsczcbqr", "irpzrz", "lsplqcsqzl", "zkqrzsslbrilb", "rcrpsils", "rcbpsp", "pzqisbsilklicpqk", "lrzpkzkqqrc", "zqqzkzcqskccbq", "zzqqbqccs", "zszsizprb", "rlclcizcpbz", "kszbilq", "lcszliqrszcrzbilczs", "bilbckccplqlzpp", "pcssbcikp", "clbsil", "zlppslrsqpkki", "pbckkipqqpbzirsppp", "qpqcssrs", "pkqcizcskrcbpirzsl", "kkzzicrsripii", "bbcpklkzqbkibbzk", "cqkkbrkczissszccpr", "brbpsrbkcbc", "bcibspzsrcqrqcqkrb", "qzcpzrzcrkqlzzi", "slrksblsclksirblzq", "rrkssr", "rcbizqzrrki", "ibilcrkissrppbqlci", "szklbplliiqirqqici", "iisicrbkcpb", "rcscz", "rzispciikbipq", "qcipcbsklqslrkczbil", "crrzqbp", "rzbcpzkrziqqq", "bplkpqrkzkirsz", "qlbrkkqbkibcbrrl", "sklcckslrkc", "ikzpbk", "ccqkqzzrkrcklbqqrri", "iklzipszk", "zkiiqbq", "zcskkb", "iszkizsbzzs", "bpcqsrlllqcrb", "ksrszipb", "llkizc", "sbqqpclqqrklbkq", "ibkzzc", "ckciilrzbslqrbszr", "iqqkl", "zzskzkklbzzbli", "crppr", "kbribq", "zkbzzklbibbkpcpqs", "bipslikrisz", "rklrslris", "rsiilbsqiqbqlrplqir", "bkzpq", "lpzqzklkbpsbrrrcs", "rckzbrbqzszizp", "blsribpcsqlp", "cqlqkspkkl", "lbrqq", "sszpkikk", "qlisrikcrrkql", "blbiqkikssrqbzcbzip", "llizzszbir", "csrlpsbckliqrirzi", "szqqspzic", "ipqcrscbsbbccl", "zzlbzslkqzrir", "blkis", "lkbrl", "cpzziik", "zzizzpbbllrlil", "bzzrkprirpclkrq", "kbiqzlcbrblbrzsrrl", "kccspbkiplzpp", "iqcizkkkizzbqslbkl", "rciqzqcrkrrqrz", "zrbqbirsqzqrsbp", "ksbbzzcszkpslkssczi", "qrriqbqrll", "rpkkcsqcpk", "zkrriqkprrsbp", "brzzippqilrcpi", "zrlks", "zzplb", "zlbpblzqlkblpc", "czqqblziqpqccci", "ciqqicipspiibzzrrs", "lsqkzipkpckkklkci", "rpllkircqkbc", "rcciqczllzpspk", "zikiz", "kqlqbcizscclzzb", "zzcbbcqp", "bqicsqkklqk", "ckiibkcrkkclppl", "qzkqcpb", "iklqlprilzkpccs", "lpsrcckiibq", "irqzp", "cilcp", "iriirq", "bqkqizsck", "iszbikqrcrccblqb", "ckqzbkcsizzpqqizccz", "zlzrsplqikbpcsr", "ksszzzzlbbbzblkkskl", "iklliiczbbbkpb", "ckkiil", "rcrks", "sckrkii", "brsbqbbqbz", "ksplrppbbz", "zqrsqcrl", "zpbpcsbcpkbpcszczp", "lcbsqspr", "slkkbkklrsliqi", "ibqpiprq", "isspr", "zqilpbcsrrkzlspsqbs", "icpcsklzkikslzqpz", "blzsisqiqbrczp", "iszibzkzrrssrpccqqr"]	true
"yyyyyyyyyyyyyyyyyyyyyyyyyyyyyyyyyyyyyyyyyyyyyyyyyyyyyyyyyyyyyyyyyyyyyyyyyyygyygyyyyyyyyyyyyyyyyyyyyyyyyyyyyyyyyyyyyyyyyyyyyyyyyyyyyyyyyyyyyyyyyyyyyyyyy"	["yyyyyy", "gy", "yyyyyyy", "yyyy", "yyy", "yyyyy", "yyyyyyyy", "yy", "yyyyyyyyyy", "yyyyyyyyy"]	false
"ataaaaazzzdztttdtdaadtdttatztttazzzztdaaaaaadz"	["aaaaa", "tttdtda", "dzdazdz", "aaddt", "dadaaad", "ztadz", "dta", "ztz", "atzz", "atza", "zzzztda", "azztzda", "tta", "z", "tzttatd", "zadz", "dttadd", "atzttd", "ttzdzt", "az", "ta", "zzta", "zdzz", "tzdaaa", "dttat", "zatztdd", "azd", "zdt", "dttzzzt", "zzdaz", "adt", "zatztz", "tzt", "ttdt", "a", "d", "ddadzad", "aa", "at", "azztdzd", "tzdztad", "tdzaz", "dz", "za", "adztadz", "t", "ttd", "zatz", "azzz", "dtzd"]	true
"aaaaaaaa"	["aa", "a", "aaaa"]	true
"mmmmmmm"	["mmm", "mmmm"]	true
"ypppppppppppppppppppppppppppppppppppppppppppppppppppppppppppppppppppppppppppppppppppppppppppppppppppppppppppppppppppppppppppppppppppppppppppppppppppppp"	["pppppppppp", "pppppppp", "pppppp", "ppppppppp", "ppp", "ppppp", "pp", "pppp", "p", "ppppppp"]	false
"fftfffefte"	["fe", "tf", "ft", "et", "ee", "ff", "ef", "tt"]	false
"ieepoexo"	["ieepo", "eoidc", "exo", "eoit"]	true
"itppkbutbbjizljnxpnyjbupbtypndxjuzzbxlttynouldypbpojajbpiaydpudknbxkjbkxatdxzaxdxzzytjnanxxbpxknboooppipijajonltzadjyopaoldnkuyatdnptiykoilxtktpbydpuuxtonzotdnzkbztbupdoe"	["kibiyp", "booknontpulj", "xbpxk", "ipdztjada", "ybydddon", "ajtadybbjouz", "anuttopdpuzza", "dltzuyox", "xtopkbopkajd", "pkzpaaynaj", "dxzzytjnanx", "bizkxapkooppu", "ukyuyk", "apjytaxuzx", "j", "nbpp", "dbxlbdxtlook", "tdydtpn", "abbb", "lapboaxapj", "lnntpo", "any", "upz", "tylzbklkponnbbo", "kujtnuzkaptdl", "ionoubu", "ddynjzyitpltlox", "y", "ddznxzyiajxklpi", "kjjkb", "bzkpixknikdub", "tpxioxztkdjntda", "kllxzooxn", "llaon", "udldy", "aip", "jtdzxa", "yylpu", "xduzojdybyzi", "pbjbiot", "djplzkluixank", "pinozutylnbn", "uitiaitnktxz", "pnb", "yukjdootbyxnl", "ltkyupupzi", "lxjnz", "uxzljz", "joynlbd", "oyzdnylktzk", "ppzzond", "xlxazubdbo", "plyiipxinxx", "l", "yydb", "xuaznxixxdd", "dd", "atainlzjzxuzy", "jjzjxjyzxxopbaz", "nlpypuaplozl", "daynllupydxyj", "jayldojyuxk", "xakzi", "lnylpjidpykuioo", "ytp", "pjazuaddyypzaj", "iaxppo", "alapzopoztb", "dkundzibodpi", "lxioyjdjzknjbl", "ytuaoptxy", "azpb", "lknltloujxyi", "lxabxjaaipjp", "abkluizb", "o", "kxtbax", "opuijz", "yxl", "pizozokkyz", "nt", "z", "ztluij", "djljoxu", "nkiionobkyd", "ni", "ioyttaanix", "knu", "tiopxb", "xdj", "tpbyd", "pjuzdd", "tbuz", "njl", "pjykk", "jodnytuazy", "zpbjzutyppnk", "xlipt", "lbxkxb", "yopaoldnku", "ptua", "njxxi", "tnpilpukxbdzuj", "pjikolk", "oxtyotounzuyyxt", "pkutuzoojkltubt", "dapoxtil", "uxxzxlz", "pdltzdzjlazuazu", "jkyipuojxdtzpat", "opua", "xlbuolpupixbzyt", "kx", "udoj", "xbaxjdx", "jajbpiaydpu", "ltldbdpkzazkjiy", "ldxodolidin", "jlxzlnnaxxnxzdl", "pjxkjtpi", "zdtidjkizktbt", "ptoxounukljud", "xpazbxdaio", "ztbakuiut", "yntbkzijktizipl", "ybttbadpokn", "njuioopbouzynlz", "txdxltz", "oaapyypyjynxlp", "do", "ntaxlktjjtjdd", "lnapntpuapx", "ijbiuipotuaxb", "njoknlukljn", "utbbj", "lnbi", "tuldzzdtayjuyk", "ybbynp", "bnkayznyajodk", "ny", "oix", "yioodpkzabpju", "ujtkjzpkxiydau", "nntddpjz", "du", "djldyd", "bdtna", "yyddnbnzdjuz", "joylyndzjliu", "tuza", "u", "tni", "punznxjn", "oubndo", "ipjyjopknkzoxd", "llznu", "plpxnpokuzn", "aixiipdaldub", "lyzoukbkjui", "b", "xykulxdytzo", "jktdnnkibzjnjo", "olzzjudkkln", "ujbpxy", "xnp", "kzunbyzlzptttx", "bxiato", "zpuo", "dtbbuxxyxtij", "nnadjtuzuid", "btltjylzob", "axnzydt", "lttynou", "xjijuxon", "litpaoopl", "d", "zutladzbdok", "yoaxzk", "nuyynkxa", "nlu", "lljlnxbtukn", "pnpunlptou", "nkitoxxb", "ount", "jpjuanbt", "dulipajzpj", "obt", "undpyzoyjx", "olbbozkkpzxdk", "ubjdykot", "xaidudplzluuy", "uubndtk", "zkitbzyaxb", "innallpybztyla", "untkuzti", "blyxxu", "unyxiplyly", "uiaknppdinxdb", "idlu", "xyayottnyaxyd", "dzpkybduotx", "pnydnxzytl", "pkbldia", "zxnpkpddlzudl", "oklltaddoz", "axlnbl", "atdtlky", "dolbktdulotkbi", "kka", "bznzdaiukzio", "dkntdypxpl", "ldypbpo", "pabotixajkbjpuo", "zujzanbpjzlijbt", "yyyzp", "ujltkzouitxu", "idtoinajztattiz", "ozittbtjajly", "jblpj", "xkulpkxdyb", "bopll", "binxkjlui", "zbpaldtoiylzx", "nioodda", "udp", "xinnonz", "uatkdainlj", "jill", "nnidkl", "iollpjixjoo", "zotdnzk", "ojtnbnnl", "jbknyyooloxnyi", "jkbyip", "ukk", "pbznbyjzplbnoyk", "ldyoyda", "nk", "kunajuxuy", "ybldttxaxbpuiz", "zpjdkjxttblaok", "dkibopzdulnix", "uylpdtb", "ndbxtlntdljbp", "abxybtdyldidxl", "bpub", "xlbdjjotal", "zjblixazk", "yybldzx", "puuxt", "byznyd", "kdpxkliypdnpbk", "xlzbjlyknpnbi", "njbyzklj", "up", "iutpdzntzyiyzll", "nnpi", "bztbupdo", "x", "uaxnpldnayk", "tydxyu", "idoxdauddkaj", "txtki", "itupouzxjypuz", "ak", "ytnnynanzji", "ndnlp", "ll", "bzznxy", "zlk", "ibpkxudxxpxnpxp", "zyuopydl", "axud", "ijiopa", "oxootajy", "xbxopzdjldpauu", "xddzixyttonlb", "nytijuxdaa", "xallkkzjlo", "tkzndilypbzyyd", "lkxblal", "nazypiuonio", "bontuia", "tntblkkauxaid", "llooyxipk", "dnxpiid", "klbnndbaoitjjn", "toyokpxzayl", "zaydalkp", "kujtz", "kobtnbjt", "nld", "ztoo", "yypzzppdau", "pldlyd", "buppotnbkjl", "xjb", "lyyaxba", "ton", "tbzpldxjyyl", "jxpklnpjdtjjt", "bjdxio", "klpxakn", "jkx", "izkloxzk", "nz", "nydouko", "judkuzaibib", "xzxnjyobjdzaxtp", "dokiaxtkunnydk", "dalduxnnjzjoyn", "uzpoyjdy", "xpxuzydynubxbkt", "xblkako", "uzdk", "pdniyjbxpjipaz", "ndxjuzzbx", "xnlkadnybttpntp", "yoinkidxtkji", "pxuzijobupp", "tlujiappkxzij", "nbooo", "txktd", "tjotdnltu", "xbu", "xikzxi", "bupblaiiidaun", "ltzadj", "nlnbut", "tkbpidipktdzbbx", "tk", "yzztxtauk", "ju", "xjddtduai", "yaa", "pxp", "inyznybpi", "oyby", "nyybxnbzibkpt", "n", "zolutyl", "yt", "uxldybz", "ljxyijxlkdzalz", "lbuxpjyz", "nkbdlkpyoyi", "pzjzy", "yiuxzdxkunadlpa", "xujyaxan", "jnbaynu", "kbd", "k", "olnziyzixjd", "kd", "yatdnptiykoilxt", "dijt", "lolnaikai", "natnydlozbnolpb", "zuplboxdpxuinp", "xixjdadbpoi", "txpbaxztzaljzan", "ajd", "kxatdxzax", "pxijbboz", "bzunxuktlxktbb", "ukkuoaxnyzjp", "aytnilkayubot", "uipjnidua", "tkitblbpjo", "kitpaak", "uua", "yxxljuaxz", "jj", "kidaxutxnillkbj", "olzjtdddkdl", "td", "zutxy", "aynbol", "dxillnlzkl", "ootoitbynnj", "iybuuoai", "udtuk", "uydkbdayilo", "xi", "zoinayzzud", "bzip", "inninanlzokkb", "janxox", "oybtp", "pktyldzpby", "ybukloui", "jyyuaiuly", "zztonpl", "znktboinyknp", "ub", "kt", "zxlyounbx", "ubuotak", "anp", "ip", "xptyyzpb", "nzojujddpoya", "laajlpz", "xlop", "unxntunkidj", "blbxittaant", "bdbjjlijjj", "plyi", "zbloltbzdjliox", "xnidiklkx", "unnpibtu", "xxpzndztdlxjbj", "i", "zduxjkzont", "kxttj", "ounxjxaxibp", "dylilzbxiajzzxa", "ljxoyydk", "nyn", "llzy", "yatznyupyabu", "uapo", "iyiop", "ajyoakndbd", "ibyokukzjuxk", "tbdpkkpoallbnz", "ulbkouxjpjoj", "bljdbnjbxb", "dxbldduinbl", "baunozopbp", "jptbybizkdlxijk", "ppipijaj", "kkjn", "tnndppjxb", "oindb", "yktuutkjan", "aauxulozk", "ndxjajdzu", "itdylukntlkyddl", "ojjdadibtjaj", "ioko", "xanpdpbdx", "ldlkzpxlndyo", "aauzoaazuktn", "kzok", "dax", "ljnxpnyjbupbtyp", "nzlzjxo", "djjakptjoi", "zxziixaxxapz", "zoy", "ukyzyyt", "oojdpyzyatkb", "ibddkxdj", "nkaxuxaonjop", "nuuypyzuiki", "jnzkdpaldn", "xdkp", "pyzitzddb", "nltpoppyazax", "kk", "njxlyknbkyyo", "lyuoyd", "onydduzidonyiua", "pzxktkndakyutn", "nydnlzy", "zatnonnlxjptajk", "poltul", "iu", "toayla", "atoupux", "ynt", "uxnbyjkbdabxz", "iibbxbl", "jpuaaoujkl", "p", "xdikixaypjn", "lpbdn", "npib", "lpiyoilp", "nikpxzjzpdpt", "ibtik", "zldnp", "xbonnlnzzpokn", "pkjllkjuizz", "uaukzzztpiun", "dpuja", "jnjpxzdipuxiya", "idaobpobbn", "dyooapo", "otpdjozzix", "otxzuuyx", "nzzbaayjbykzbld", "ljdl", "ytaany", "jaoodxiouobytio", "lxodukouput", "zjxalipdyz", "kxbio", "lbyiayyiyn", "blkbokkltijniop", "ku", "ptijuakjt", "nyduxijxijujkb", "inpoz", "njzxzkxzb", "xzlndnnubd", "bpnkdiuapydok", "bunankjpxzpz", "yaoijdx", "uodduntpj", "xkkuljkopak", "inptpnonpnkyljk", "dnlzlbpaujtdb", "pttaaxdxxn", "pzuiu", "unbljzplt", "zypozluz", "au", "xyuodidnbunjt", "uxkl", "patlilnpjuyd", "zxb", "xypjoxdljuobaod", "kbkpijzxlntuyl", "puotppidpjid", "polzpujtbnbdbt", "zztpodnibxoa", "toubapzjlzuy", "uinxzjtib", "dddoxlklapy", "bkjltyiup", "onuldyuaptt", "ikjjza", "lzbpnokonokui", "uo", "ytkauziulubn", "bbxbyotajtkjjz", "yduibkijkaby", "pt", "paxzzkliu", "ndluiyptz", "lzbikxldznnit", "ppylaakjdioan", "pupjtnx", "npatjlyitxjkz", "jjbyjiaxdtdjb", "jjtokl", "juxkzbazkztjyt", "lkdbzzjptkdki", "upkbxdjattalt", "txjybtxaldbol", "yudlltxnyxyn", "yiinzdbojptu", "aoa", "ptxttaku", "xltounzbnoa", "ldbatjdaaljobty", "ypoa", "oonibzkkay", "nitnxdaoynudxkn", "kojtpyltjxy", "zpodzdlan", "uddjdpibizp", "axytkokd", "utippujpxdd", "jtxbt", "ydznlxdjtkonyj", "xjxpldjt", "npxuoaolxbap", "byzlnljzil", "pl", "npkbjxkok", "kzjabpdp", "oxyi", "oldkktzz", "badtdlktby", "zuzjuxilnzkdj", "louktbtbbkpu", "xdtnpulnioxyxix", "txnoxzoyaidbt", "pbxjazpdan", "ikkzbdkpanxpl", "jbjxy", "nkujxjaz", "itp", "uxklubdnxbpb", "ppknooabuly", "kyiniojkbnkjuld", "lxiaxuul", "ninja", "ojadtntjul", "kdk", "jiknulokujpa", "on", "ydzibzbzpioat", "lyduynkzxokjay", "uyxapi", "ntdybyxaaz", "t", "upjtululyxn", "xjkallndbzkjko", "xnaijdxopitiau", "iyjlxpy", "kybuozipikodzdd", "nnaaitizo", "kdplnbdkobzl", "aiadydujdkxxp", "kjoazaxydkb", "lzuilbjtbut", "dutpylxa", "aiyyttndjzzonu", "ukpypzdkpj", "iluzpoljla", "okzj", "itppkb", "kj", "xlzdd", "oab", "xajxxalauzj", "bo", "zkdpdujaalxbkk", "blz", "btjpzdlypnkp", "iz", "yyaztyxnkjkdlj", "abniknitazx", "pdzljonx", "zotopxklbuzlouz", "nlnblaptyly", "iuybalbu", "zxzbj", "izlzxdoa", "na", "dknbxkjb", "kluoyduzondot", "aiaoilnkauxyyxj", "bkbxzi", "jxoydlnlppulknu", "ninkzpzbpadyaau", "zuktlp", "lixjbna", "at", "xuzz", "uxdkttpbpapl", "ixzpnkalzbklk", "kjtby", "zooapit", "dojk", "duzjyozp"]	false
"wgmmylddayogboygaybddgyjdgwmlgmdobldhholxalq"	["dwblmfw", "mg", "kafghkomjmfd", "owwmfqbak", "qwooqwx", "xlaoykqakggdak", "fwxlaaklbjf", "ombllxya", "xxwdwaxaha", "wyj", "gmxgmq", "bdahflwhylbwh", "wmyghkb", "kafyl", "j", "allyyxxdojhfbog", "lgkgdkkm", "yogboygaybddgyj", "bgyqabkqghhb", "ykaqxxfwwd", "gjwaookwk", "qlykoqwxmday", "dgwbllbl", "y", "obbgk", "wyo", "ydjfall", "ldydx", "hjoxbb", "dfyyh", "l", "qldygfojqjqqwfl", "dd", "hflbwjggyydg", "gjhfxakd", "fqx", "wfkkkyaxdxlgglf", "hhodkb", "hgadbbxd", "wmqo", "ooqyaffxkmfblb", "dobldhholxalq", "mh", "wxfggkgfom", "qwbfxyfkwkjbyk", "o", "qymwmbbblqk", "bmkykgjhyydb", "odblqm", "qfqwjkwyyomofak", "moqlgmkxq", "dgkaqbgqofo", "qgmomawfyha", "lbmb", "dmmgo", "ajhgyb", "hadgbyfkd", "jggmgoxajj", "ffkbbxxqdjmh", "mlqf", "hhb", "yhkdojjj", "xga", "qjkkffx", "waxydjxygaallf", "hohmhfylbyhy", "hookhogagbo", "lhdabfxbyjyqyy", "abayxhlojkfd", "aohhdaoamwmdjxy", "f", "dxyo", "yfbwgqjjxjqm", "wf", "ofhmfaobfwl", "ydkqxhylhjbxoaa", "xxdlwykxyylwhok", "qgxkxkmbodw", "mbdxgalbfwmodf", "kmfx", "bjkxqjxhdwwwflq", "ok", "dklyj", "djddy", "dllqdhdmxx", "xoqdaj", "yhkjyqfqqxgao", "oylgjmlfolhk", "qjdwj", "jkgymqlyx", "bymjdhllgwqmjq", "haodgddfmb", "mqwobdkgyfyk", "b", "jh", "odwoqflxqdx", "lmm", "hxbwy", "g", "aqyadjgdqfb", "mohajqkf", "d", "owlg", "xbhoghylkxgmk", "xammoqldbmbhf", "jqkfmk", "whhqq", "afqywlbkjlkx", "fwakjabw", "axgflxqdb", "mjkywxflhdkg", "ojbobmgxbhqahdf", "jjqyobxdlhffyq", "glam", "xldyadgmqowjbw", "oowxwbakomo", "qlqfylmjh", "yjoqqwdaww", "xdbj", "ykjblk", "ykfh", "maofaaldmfkxdd", "fomwy", "haylahgfbwo", "agyaa", "flyqlq", "gmhdywdajgxawh", "wybklgh", "bmj", "hwdxhyyfxhhg", "gdqalh", "hdl", "owbqy", "gwx", "kwjdxhgflqd", "wfoh", "mmmbghd", "x", "wmmyyjajalkxyjm", "ohja", "dhmkbbqdfaoj", "hhbkbbbw", "dkbxqoqdbym", "aygbmokljx", "axkmmmmh", "mddolfkbkgbdhml", "wofgbjhgaga", "gyhwohmkhakoxxg", "am", "qwajohlhbaa", "xyfx", "oghjkbkhyd", "xahwammkbm", "lojkfhkgxqx", "famohhbhlkw", "alkbbwyamojkwjh", "fwahxwokh", "yqgkjkqbllka", "xayjlog", "hqqh", "gfd", "jhgyoaljkqayyga", "yb", "glfxhggqodxyk", "dg", "fhglhgmk", "mmbqbwqgjwq", "bjj", "hwmdj", "dhh", "ymwxhgo", "bbqajkhw", "amfqwxxgakjhfb", "xqbkw", "jgqaqhokl", "gjmfk", "wdxhfhaxlm", "k", "ykxjbogjxmoo", "mydkaalawqglya", "kqqfbboqxq", "dy", "alkgb", "adh", "jfjjqwxgbwqfma", "wlw", "ojjlwyodmyyg", "hx", "bjjwdwfffmqa", "dwglda", "qmybm", "h", "ybkmjd", "wyloaxkkxjgm", "gxoak", "lkdmd", "dxjdmfyfhm", "oyoxkwfaaxodjdb", "yjgljfqfmqw", "folaxlbjyafjg", "yjydjxqfba", "aoxbymhdwkhdj", "qhx", "odkxa", "obxqfyxykl", "gyldxlwwhoqg", "w", "jb", "hoxfgaxm", "aaqdhagkmkkmkl", "qabmlh", "bdgwmbyf", "aolq", "hqobgh", "wg", "goyakdffyo", "bawghqbda", "qybx", "qmyy", "kykykqmadym", "ba", "oakfo", "kamj", "wwhjjobfkymmhhg", "qyoj", "dwgdffdkkloj", "fbb", "xhxwhhgblmokdbj", "wlgqxaoyfkk", "dlww", "wo", "obhajlwggjlfa", "bhjfklmklwqb", "ggabddq", "q", "fmoxw", "fbfmolja", "mq", "ylfjqf", "bm", "xfydloxadqw", "hbxwdghdbygfg", "ljlojhbykmhd", "whamlqmgjgklmfq", "wjgqgmqdmaohf", "ax", "khwbbfhggdlxgy", "fwwkoljdg", "mhgmyjxldamjq", "jy", "jdd", "ggwgmjghf", "moxxkghbwllbola", "ghyg", "oqqqffyjdkxxd", "fhlod", "fjwagxofmwdjfbj", "bqx", "xabywyfhmofdbwk", "ojhdfx", "dwmdxjljgbmqjh", "lgbwb", "ygkyha", "dgwqh", "oyd", "jkwlbmlqga", "qboyqjmmablba", "kofbfh", "mfjq", "ghgkgo", "mhqooqhyymljk", "hdoaxaowbwmghbo", "kgl", "dfllqmf", "wjdflqo", "kqmaqgkkwxyl", "xjghjdbbdw", "kl", "ylmykffja", "gbaddkmk", "baqdfoqao", "ybw", "jhmflkbbghda", "blmlj", "kfhh", "bfwhl", "kkkqojmqmx", "oohamqdffk", "jkbla", "wmw", "lkwhkhxq", "mjjkojqaqkmj", "bkjdowgl", "fa", "ymh", "owhoojlyoyl", "amwmoj", "mdm", "ffqkx", "jhmkah", "xjomdbjx", "xxdkwfyyohyjqy", "qwbobdwxlhboxlq", "yxymfqfxmwbj", "ablqql", "hk", "dlfxbgakxmdq", "ah", "mghgkkgxhbg", "xoobfxkjxyqbo", "dgwmlgm", "wjojagfmkmhb", "lagbfoyhjalx", "wddjbdxamalowf", "mqbwjoomjqkok", "kyqgkkkxbb", "owjokkboh", "myoahfxhalfqq", "bjjbwxxbgqjoxl", "wfkf", "fyhxdghw", "jkjfklxfqwxlkg", "fwffkgwd", "klfyxb", "kybwoyy", "ghajbmalfbqdoy", "dggyxfyggxhoky", "lkfa", "oyfmakdxhkgay", "dgfmmywfff", "mdyfjqyfyow", "jxalwmaw", "jmjyjgmkhmd", "qwdflfgj", "hlkklbfgjmhkko", "xyh", "wd", "wgmmyldda", "md", "qdxqggqoll", "owjkqbxlhbgyfk", "wjxbmm", "lwq", "fhkhmbxjkd", "byxgohg", "fqj", "xfd", "dbybwmfog", "hbmhkqkgoqw", "laqmbx"]	true
"x"	[]	false
"aeesk"	["ekamq", "ekag", "aeesk"]	true
"ccccccc"	["cc", "c", "cccc"]	true
